Booked At;Text;Credit/Debit Amount;Balance;Valuta Date
2017-12-01 01:23:58.0;X-Nulitur Arenatu (Merit�patesse) Plabilige Ponuntiore  Merit MNhnard8452637616;-200;19647.09;2017-12-01 00:00:00.0
2017-12-01 01:23:58.0;X-Nulitur Arenatu (Merit�patesse) Plabilige Ponuntiore  Merit MNhnard8452637616;-40.3;19606.79;2017-12-01 00:00:00.0
2017-12-01 01:23:58.0;X-Nulitur Arenatu (Merit�patesse) Plabilige Ponuntiore  Merit MNhnard8452637616;-4;19602.79;2017-12-01 00:00:00.0
2017-12-01 01:23:58.0;X-Nulitur Arenatu (Merit�patesse) Plabilige Ponuntiore  Merit MNhnard8452637616;-39.6;19563.19;2017-12-01 00:00:00.0
2017-12-01 01:23:58.0;X-Nulitur Arenatu (Merit�patesse) Plabilige Ponuntiore  Merit MNhnard8452637616;-20;19543.19;2017-12-01 00:00:00.0
2017-12-05 17:18:53.0;X-Nulitur Arenatu (Merit�patesse) Plabilige Ponuntiore  Merit MNhnard8452637616;-4.3;19538.89;2017-12-05 00:00:00.0
