Bewertungsdatum;Bankbeziehung;Portfolio;Produkt;IBAN;Whrg.;Datum von;Datum bis;Beschreibung;Abschluss;Buchungsdatum;Valuta;Beschreibung 1;Beschreibung 2;Beschreibung 3;Transaktions-Nr.;Devisenkurs zum Originalbetrag in Abrechnungswährung;Einzelbetrag;Belastung;Gutschrift;Saldo
09.03.2023;0273 76460372;;0273 76460372.0;MV30 8436 5080 7434 4343 2;MOX;01.01.2023;31.01.2023;COR Momulamquado Scipsilocet;03.01.2023;03.01.2023;03.01.2023;Mitaümili;MUNIMINON PEREPS;VENDISTAS 4, AT/BRUNTUS 6265, VENDEDEINCERVIS: N-35683 SION AUTAS,  WIRIANA: 1086583 PARARIS COR: 65.7, 4 .6017;9999003ZC2542588;;;;1'770.00;35'217.27
09.03.2023;0273 76460372;;0273 76460372.0;MV30 8436 5080 7434 4343 2;MOX;01.01.2023;31.01.2023;COR Momulamquado Scipsilocet;03.01.2023;03.01.2023;03.01.2023;Sendividiam- per Autimenavitatunava;;;9999003ZC2542588;;;;;
09.03.2023;0273 76460372;;0273 76460372.0;MV30 8436 5080 7434 4343 2;MOX;01.01.2023;31.01.2023;COR Momulamquado Scipsilocet;03.01.2023;03.01.2023;03.01.2023;Conatunubelegro HAT;;;9999003ZC2542588;;;;;
09.03.2023;0273 76460372;;0273 76460372.0;MV30 8436 5080 7434 4343 2;MOX;01.01.2023;31.01.2023;COR Momulamquado Scipsilocet;03.01.2023;03.01.2023;03.01.2023;Minnent agrascem Aciroducultinquaestimo;;;9999003ZC2542588;;;;;
09.03.2023;0273 76460372;;0273 76460372.0;MV30 8436 5080 7434 4343 2;MOX;01.01.2023;31.01.2023;COR Momulamquado Scipsilocet;03.01.2023;03.01.2023;03.01.2023;Mineque Lodiscususäan;TOTE-AREANT BY, PRORSALVERE. 28,;6438 IBACH;9973503LP0750740;;;80.00;;35'137.27
09.03.2023;0273 76460372;;0273 76460372.0;MV30 8436 5080 7434 4343 2;MOX;01.01.2023;31.01.2023;COR Momulamquado Scipsilocet;03.01.2023;03.01.2023;03.01.2023;g-intetis-Pillameruntio;;;9973003TJ8043530;;;1'826.77;;33'310.50
09.03.2023;0273 76460372;;0273 76460372.0;MV30 8436 5080 7434 4343 2;MOX;01.01.2023;31.01.2023;COR Momulamquado Scipsilocet;03.01.2023;03.01.2023;03.01.2023;SORE OMNIUNTUUNT BY;AT PARAEPE;;9973003TJ8043530;;-90.470000000;;;
09.03.2023;0273 76460372;;0273 76460372.0;MV30 8436 5080 7434 4343 2;MOX;01.01.2023;31.01.2023;COR Momulamquado Scipsilocet;03.01.2023;03.01.2023;03.01.2023;AUDIT PESTANT;AT;;9973003TJ8043530;;-589.700000000;;;
09.03.2023;0273 76460372;;0273 76460372.0;MV30 8436 5080 7434 4343 2;MOX;01.01.2023;31.01.2023;COR Momulamquado Scipsilocet;03.01.2023;03.01.2023;03.01.2023;FREX PERAE;AT;;9973003TJ8043530;;-1146.600000000;;;
09.03.2023;0273 76460372;;0273 76460372.0;MV30 8436 5080 7434 4343 2;MOX;01.01.2023;31.01.2023;COR Momulamquado Scipsilocet;04.01.2023;04.01.2023;04.01.2023;Portuuntio;INERIGERE PARAEPE BY;8005 ZUERICH, /ROC/202212300009756, ALL  /   3491.55/NR.0000009756/KOM., 23.21/DAT.30.12.2022/BIKE + CLIMB, UP     /IBACH, Gutschrifts- und Belastungsanzeigen;9901865E67267353;;;;3'468.34;36'778.84
09.03.2023;0273 76460372;;0273 76460372.0;MV30 8436 5080 7434 4343 2;MOX;01.01.2023;31.01.2023;COR Momulamquado Scipsilocet;04.01.2023;04.01.2023;04.01.2023;Portuuntio;INERIGERE PARAEPE BY;8005 ZUERICH, /ROC/202212310015223, ALL  /   3061.25/NR.0010015223/KOM., 15.39/DAT.31.12.2022/BIKE + CLIMB, UP     /IBACH, Gutschrifts- und Belastungsanzeigen;9901501E67330923;;;;3'045.86;39'824.70
09.03.2023;0273 76460372;;0273 76460372.0;MV30 8436 5080 7434 4343 2;MOX;01.01.2023;31.01.2023;COR Momulamquado Scipsilocet;04.01.2023;04.01.2023;04.01.2023;Ligneranate;EUK8D RENTUDITQUE VI COR;DOMNIS 41 FLONE, MATIS-PULECT BY, 1308 LAMAGE;9973504KH7295786;;;1'154.10;;38'670.60
09.03.2023;0273 76460372;;0273 76460372.0;MV30 8436 5080 7434 4343 2;MOX;01.01.2023;31.01.2023;COR Momulamquado Scipsilocet;04.01.2023;04.01.2023;04.01.2023;Sendividiam- per Autimenavitatunava;;;9973504KH7295786;;;;;
09.03.2023;0273 76460372;;0273 76460372.0;MV30 8436 5080 7434 4343 2;MOX;01.01.2023;31.01.2023;COR Momulamquado Scipsilocet;04.01.2023;04.01.2023;04.01.2023;PRA Volfabeat MOX;;;9973504KH7295786;;;;;
09.03.2023;0273 76460372;;0273 76460372.0;MV30 8436 5080 7434 4343 2;MOX;01.01.2023;31.01.2023;COR Momulamquado Scipsilocet;04.01.2023;04.01.2023;04.01.2023;Minnent agrascem Aciroducultinquaestimo;;;9973504KH7295786;;;;;
09.03.2023;0273 76460372;;0273 76460372.0;MV30 8436 5080 7434 4343 2;MOX;01.01.2023;31.01.2023;COR Momulamquado Scipsilocet;03.01.2023;04.01.2023;04.01.2023;Mitaüdidissictrum;;;RH34223P76665054;;;7'287.25;;31'383.35
09.03.2023;0273 76460372;;0273 76460372.0;MV30 8436 5080 7434 4343 2;MOX;01.01.2023;31.01.2023;COR Momulamquado Scipsilocet;03.01.2023;04.01.2023;04.01.2023;ATE VINATE & OPTURRUM PRA. BY;AT 2332 MINTO;;RH34223P76665054;;-184.400000000;;;
09.03.2023;0273 76460372;;0273 76460372.0;MV30 8436 5080 7434 4343 2;MOX;01.01.2023;31.01.2023;COR Momulamquado Scipsilocet;03.01.2023;04.01.2023;04.01.2023;PRA CANS RENTIA ADRALL AT;AT 6620 PERVIAM-CAERUNT;;RH34223P76665054;;-99.900000000;;;
09.03.2023;0273 76460372;;0273 76460372.0;MV30 8436 5080 7434 4343 2;MOX;01.01.2023;31.01.2023;COR Momulamquado Scipsilocet;03.01.2023;04.01.2023;04.01.2023;PARE AT BY;AT 5770 ADUM;;RH34223P76665054;;-44.000000000;;;
09.03.2023;0273 76460372;;0273 76460372.0;MV30 8436 5080 7434 4343 2;MOX;01.01.2023;31.01.2023;COR Momulamquado Scipsilocet;03.01.2023;04.01.2023;04.01.2023;FIGUN SUUNIS AT;AT 6882 MINITION;;RH34223P76665054;;-618.080000000;;;
09.03.2023;0273 76460372;;0273 76460372.0;MV30 8436 5080 7434 4343 2;MOX;01.01.2023;31.01.2023;COR Momulamquado Scipsilocet;03.01.2023;04.01.2023;04.01.2023;ALUCI SUUNIS DIFIG BY;AT AT-7267 RECT;;RH34223P76665054;;-335.750000000;;;
09.03.2023;0273 76460372;;0273 76460372.0;MV30 8436 5080 7434 4343 2;MOX;01.01.2023;31.01.2023;COR Momulamquado Scipsilocet;03.01.2023;04.01.2023;04.01.2023;ACITARE SUPA;AT PULTUDO 7526;;RH34223P76665054;;-328.750000000;;;
09.03.2023;0273 76460372;;0273 76460372.0;MV30 8436 5080 7434 4343 2;MOX;01.01.2023;31.01.2023;COR Momulamquado Scipsilocet;03.01.2023;04.01.2023;04.01.2023;PRATUER SULUM PARAEPE BY;NAVICILEVOLECENTO 12;AT ICURA 4758;RH34223P76665054;;-2777.570000000;;;
09.03.2023;0273 76460372;;0273 76460372.0;MV30 8436 5080 7434 4343 2;MOX;01.01.2023;31.01.2023;COR Momulamquado Scipsilocet;03.01.2023;04.01.2023;04.01.2023;ATE VINATE & OPTURRUM PRA. BY;AT 2332 MINTO;;RH34223P76665054;;-1762.200000000;;;
09.03.2023;0273 76460372;;0273 76460372.0;MV30 8436 5080 7434 4343 2;MOX;01.01.2023;31.01.2023;COR Momulamquado Scipsilocet;03.01.2023;04.01.2023;04.01.2023;PRA CANS RENTIA ADRALL AT;AT PERVIAM-CAERUNT 6620;;RH34223P76665054;;-1136.600000000;;;
09.03.2023;0273 76460372;;0273 76460372.0;MV30 8436 5080 7434 4343 2;MOX;01.01.2023;31.01.2023;COR Momulamquado Scipsilocet;06.01.2023;06.01.2023;06.01.2023;Portuuntio;INERIGERE PARAEPE BY;8005 ZUERICH, /ROC/202301040006602, ALL  /   1904.45/NR.0040006602/KOM., 22.67/DAT.04.01.2023/BIKE + CLIMB, UP     /IBACH, Gutschrifts- und Belastungsanzeigen;9901505E67834289;;;;1'881.78;33'265.13
09.03.2023;0273 76460372;;0273 76460372.0;MV30 8436 5080 7434 4343 2;MOX;01.01.2023;31.01.2023;COR Momulamquado Scipsilocet;06.01.2023;06.01.2023;06.01.2023;Mitaümili;AMULUMUS EVENTIUNT;AQUILLUVIGUNIS 8, AT/INTIUNA 4432, VENDEDEINCERVIS: N-75054 SION AUTAS,  WIRIANA: 63676 PARARIS COR: 12.36., 7 761;9999006ZC4456459;;;;534.00;33'799.13
09.03.2023;0273 76460372;;0273 76460372.0;MV30 8436 5080 7434 4343 2;MOX;01.01.2023;31.01.2023;COR Momulamquado Scipsilocet;06.01.2023;06.01.2023;06.01.2023;Sendividiam- per Autimenavitatunava;;;9999006ZC4456459;;;;;
09.03.2023;0273 76460372;;0273 76460372.0;MV30 8436 5080 7434 4343 2;MOX;01.01.2023;31.01.2023;COR Momulamquado Scipsilocet;06.01.2023;06.01.2023;06.01.2023;Conatunubelegro HAT;;;9999006ZC4456459;;;;;
09.03.2023;0273 76460372;;0273 76460372.0;MV30 8436 5080 7434 4343 2;MOX;01.01.2023;31.01.2023;COR Momulamquado Scipsilocet;06.01.2023;06.01.2023;06.01.2023;Minnent agrascem Aciroducultinquaestimo;;;9999006ZC4456459;;;;;
09.03.2023;0273 76460372;;0273 76460372.0;MV30 8436 5080 7434 4343 2;MOX;01.01.2023;31.01.2023;COR Momulamquado Scipsilocet;06.01.2023;06.01.2023;06.01.2023;Ligneranate;FACUT RENTUDITQUE VI COR;DOMNIS 41 FLONE, AUSTAM . UT BY, 2748 HYACTAMIUNT, 7455/48/65 / 4321023;9973506KH7331240;;;145.91;;33'653.22
09.03.2023;0273 76460372;;0273 76460372.0;MV30 8436 5080 7434 4343 2;MOX;01.01.2023;31.01.2023;COR Momulamquado Scipsilocet;06.01.2023;06.01.2023;06.01.2023;Sendividiam- per Autimenavitatunava;;;9973506KH7331240;;;;;
09.03.2023;0273 76460372;;0273 76460372.0;MV30 8436 5080 7434 4343 2;MOX;01.01.2023;31.01.2023;COR Momulamquado Scipsilocet;06.01.2023;06.01.2023;06.01.2023;PRA Volfabeat MOX;;;9973506KH7331240;;;;;
09.03.2023;0273 76460372;;0273 76460372.0;MV30 8436 5080 7434 4343 2;MOX;01.01.2023;31.01.2023;COR Momulamquado Scipsilocet;06.01.2023;06.01.2023;06.01.2023;Minnent agrascem Aciroducultinquaestimo;;;9973506KH7331240;;;;;
09.03.2023;0273 76460372;;0273 76460372.0;MV30 8436 5080 7434 4343 2;MOX;01.01.2023;31.01.2023;COR Momulamquado Scipsilocet;09.01.2023;09.01.2023;09.01.2023;Portuuntio;INERIGERE PARAEPE BY;8005 ZUERICH, /ROC/202301050008544, ALL  /   2548.35/NR.0050008544/KOM., 24.11/DAT.05.01.2023/BIKE + CLIMB, UP     /IBACH, Gutschrifts- und Belastungsanzeigen;9901506E67989085;;;;2'524.24;36'177.46
09.03.2023;0273 76460372;;0273 76460372.0;MV30 8436 5080 7434 4343 2;MOX;01.01.2023;31.01.2023;COR Momulamquado Scipsilocet;10.01.2023;10.01.2023;10.01.2023;Portuuntio;INERIGERE PARAEPE BY;8005 ZUERICH, /ROC/202301070008414, ALL  /   5349.05/NR.0070008414/KOM., 48.01/DAT.07.01.2023/BIKE + CLIMB, UP     /IBACH, Gutschrifts- und Belastungsanzeigen;9901508E68176744;;;;5'301.04;41'478.50
09.03.2023;0273 76460372;;0273 76460372.0;MV30 8436 5080 7434 4343 2;MOX;01.01.2023;31.01.2023;COR Momulamquado Scipsilocet;10.01.2023;10.01.2023;10.01.2023;Mitaümili;CERUNUIRELIQUE;AQUILLUVIGUNIS 4, NERATEGO 818, 4778 FECTUS AT, SCUSTARE DECIMINTATONTO;9999010ZC5688413;;;;2'990.77;44'469.27
09.03.2023;0273 76460372;;0273 76460372.0;MV30 8436 5080 7434 4343 2;MOX;01.01.2023;31.01.2023;COR Momulamquado Scipsilocet;10.01.2023;10.01.2023;10.01.2023;Sendividiam- per Autimenavitatunava;;;9999010ZC5688413;;;;;
09.03.2023;0273 76460372;;0273 76460372.0;MV30 8436 5080 7434 4343 2;MOX;01.01.2023;31.01.2023;COR Momulamquado Scipsilocet;10.01.2023;10.01.2023;10.01.2023;Conatunubelegro HAT;;;9999010ZC5688413;;;;;
09.03.2023;0273 76460372;;0273 76460372.0;MV30 8436 5080 7434 4343 2;MOX;01.01.2023;31.01.2023;COR Momulamquado Scipsilocet;10.01.2023;10.01.2023;10.01.2023;Minnent agrascem Aciroducultinquaestimo;;;9999010ZC5688413;;;;;
09.03.2023;0273 76460372;;0273 76460372.0;MV30 8436 5080 7434 4343 2;MOX;01.01.2023;31.01.2023;COR Momulamquado Scipsilocet;11.01.2023;11.01.2023;11.01.2023;Mitaümili;IMUSA OFFERE-RENTATE PER SENT CANGI;T, LIQUALL 41, 7047 LINANTRIER AT, N-78846 TRA;9999011ZC6023530;;;;663.40;45'132.67
09.03.2023;0273 76460372;;0273 76460372.0;MV30 8436 5080 7434 4343 2;MOX;01.01.2023;31.01.2023;COR Momulamquado Scipsilocet;11.01.2023;11.01.2023;11.01.2023;Sendividiam- per Autimenavitatunava;;;9999011ZC6023530;;;;;
09.03.2023;0273 76460372;;0273 76460372.0;MV30 8436 5080 7434 4343 2;MOX;01.01.2023;31.01.2023;COR Momulamquado Scipsilocet;11.01.2023;11.01.2023;11.01.2023;Conatunubelegro HAT;;;9999011ZC6023530;;;;;
09.03.2023;0273 76460372;;0273 76460372.0;MV30 8436 5080 7434 4343 2;MOX;01.01.2023;31.01.2023;COR Momulamquado Scipsilocet;11.01.2023;11.01.2023;11.01.2023;Minnent agrascem Aciroducultinquaestimo;;;9999011ZC6023530;;;;;
09.03.2023;0273 76460372;;0273 76460372.0;MV30 8436 5080 7434 4343 2;MOX;01.01.2023;31.01.2023;COR Momulamquado Scipsilocet;12.01.2023;12.01.2023;12.01.2023;Mitaümili;LODICARECITTIFFERE;AT, VENDEDEINCERVIS: N-26485 SION AUTAS,  WIRIANA: 7468551 PARARIS COR: 50.7, 7 .6017;9999012ZC6185827;;;;5'572.00;50'704.67
09.03.2023;0273 76460372;;0273 76460372.0;MV30 8436 5080 7434 4343 2;MOX;01.01.2023;31.01.2023;COR Momulamquado Scipsilocet;12.01.2023;12.01.2023;12.01.2023;Subüan xxx Pare uüt Lodicarecittiffere;;;9999012ZC6185827;;-3.950000000;;;
09.03.2023;0273 76460372;;0273 76460372.0;MV30 8436 5080 7434 4343 2;MOX;01.01.2023;31.01.2023;COR Momulamquado Scipsilocet;12.01.2023;12.01.2023;12.01.2023;Sendividiam- per Autimenavitatunava;;;9999012ZC6185827;;;;;
09.03.2023;0273 76460372;;0273 76460372.0;MV30 8436 5080 7434 4343 2;MOX;01.01.2023;31.01.2023;COR Momulamquado Scipsilocet;12.01.2023;12.01.2023;12.01.2023;Conatunubelegro HAT;;;9999012ZC6185827;;;;;
09.03.2023;0273 76460372;;0273 76460372.0;MV30 8436 5080 7434 4343 2;MOX;01.01.2023;31.01.2023;COR Momulamquado Scipsilocet;12.01.2023;12.01.2023;12.01.2023;Minnent agrascem Aciroducultinquaestimo;;;9999012ZC6185827;;;;;
09.03.2023;0273 76460372;;0273 76460372.0;MV30 8436 5080 7434 4343 2;MOX;01.01.2023;31.01.2023;COR Momulamquado Scipsilocet;12.01.2023;12.01.2023;12.01.2023;Ligneranate;PPY2A RENTUDITQUE VI COR;DOMNIS 41 FLONE, ANTE UT VOLLIA NUM BY, 5732 VADDUCIPARI, XXX 6061628 / 35.36.10;9973512KH7384431;;;59.95;;50'644.72
09.03.2023;0273 76460372;;0273 76460372.0;MV30 8436 5080 7434 4343 2;MOX;01.01.2023;31.01.2023;COR Momulamquado Scipsilocet;12.01.2023;12.01.2023;12.01.2023;Sendividiam- per Autimenavitatunava;;;9973512KH7384431;;;;;
09.03.2023;0273 76460372;;0273 76460372.0;MV30 8436 5080 7434 4343 2;MOX;01.01.2023;31.01.2023;COR Momulamquado Scipsilocet;12.01.2023;12.01.2023;12.01.2023;PRA Volfabeat MOX;;;9973512KH7384431;;;;;
09.03.2023;0273 76460372;;0273 76460372.0;MV30 8436 5080 7434 4343 2;MOX;01.01.2023;31.01.2023;COR Momulamquado Scipsilocet;12.01.2023;12.01.2023;12.01.2023;Minnent agrascem Aciroducultinquaestimo;;;9973512KH7384431;;;;;
09.03.2023;0273 76460372;;0273 76460372.0;MV30 8436 5080 7434 4343 2;MOX;01.01.2023;31.01.2023;COR Momulamquado Scipsilocet;11.01.2023;12.01.2023;12.01.2023;Ligneranate;GMQ8E RENTUDITQUE VI COR;DOMNIS 41 FLONE, INTIMITIPE BY, 2602 ATUSUS;9973511KH7372743;;;87.71;;50'557.01
09.03.2023;0273 76460372;;0273 76460372.0;MV30 8436 5080 7434 4343 2;MOX;01.01.2023;31.01.2023;COR Momulamquado Scipsilocet;11.01.2023;12.01.2023;12.01.2023;Sendividiam- per Autimenavitatunava;;;9973511KH7372743;;;;;
09.03.2023;0273 76460372;;0273 76460372.0;MV30 8436 5080 7434 4343 2;MOX;01.01.2023;31.01.2023;COR Momulamquado Scipsilocet;11.01.2023;12.01.2023;12.01.2023;PRA Volfabeat MOX;;;9973511KH7372743;;;;;
09.03.2023;0273 76460372;;0273 76460372.0;MV30 8436 5080 7434 4343 2;MOX;01.01.2023;31.01.2023;COR Momulamquado Scipsilocet;11.01.2023;12.01.2023;12.01.2023;Minnent agrascem Aciroducultinquaestimo;;;9973511KH7372743;;;;;
09.03.2023;0273 76460372;;0273 76460372.0;MV30 8436 5080 7434 4343 2;MOX;01.01.2023;31.01.2023;COR Momulamquado Scipsilocet;12.01.2023;12.01.2023;12.01.2023;Ligneranate;PPY2A RENTUDITQUE VI COR;DOMNIS 41 FLONE, ANTE UT VOLLIA NUM BY, 5732 VADDUCIPARI, XXX 4773484 / 55.36.10;9973512KH7384462;;;122.45;;50'434.56
09.03.2023;0273 76460372;;0273 76460372.0;MV30 8436 5080 7434 4343 2;MOX;01.01.2023;31.01.2023;COR Momulamquado Scipsilocet;12.01.2023;12.01.2023;12.01.2023;Sendividiam- per Autimenavitatunava;;;9973512KH7384462;;;;;
09.03.2023;0273 76460372;;0273 76460372.0;MV30 8436 5080 7434 4343 2;MOX;01.01.2023;31.01.2023;COR Momulamquado Scipsilocet;12.01.2023;12.01.2023;12.01.2023;PRA Volfabeat MOX;;;9973512KH7384462;;;;;
09.03.2023;0273 76460372;;0273 76460372.0;MV30 8436 5080 7434 4343 2;MOX;01.01.2023;31.01.2023;COR Momulamquado Scipsilocet;12.01.2023;12.01.2023;12.01.2023;Minnent agrascem Aciroducultinquaestimo;;;9973512KH7384462;;;;;
09.03.2023;0273 76460372;;0273 76460372.0;MV30 8436 5080 7434 4343 2;MOX;01.01.2023;31.01.2023;COR Momulamquado Scipsilocet;11.01.2023;12.01.2023;12.01.2023;Ligneranate;GMQ8E RENTUDITQUE VI COR;DOMNIS 41 FLONE, INTIMITIPE BY, 2602 ATUSUS;9973511KH7372749;;;123.09;;50'311.47
09.03.2023;0273 76460372;;0273 76460372.0;MV30 8436 5080 7434 4343 2;MOX;01.01.2023;31.01.2023;COR Momulamquado Scipsilocet;11.01.2023;12.01.2023;12.01.2023;Sendividiam- per Autimenavitatunava;;;9973511KH7372749;;;;;
09.03.2023;0273 76460372;;0273 76460372.0;MV30 8436 5080 7434 4343 2;MOX;01.01.2023;31.01.2023;COR Momulamquado Scipsilocet;11.01.2023;12.01.2023;12.01.2023;PRA Volfabeat MOX;;;9973511KH7372749;;;;;
09.03.2023;0273 76460372;;0273 76460372.0;MV30 8436 5080 7434 4343 2;MOX;01.01.2023;31.01.2023;COR Momulamquado Scipsilocet;11.01.2023;12.01.2023;12.01.2023;Minnent agrascem Aciroducultinquaestimo;;;9973511KH7372749;;;;;
09.03.2023;0273 76460372;;0273 76460372.0;MV30 8436 5080 7434 4343 2;MOX;01.01.2023;31.01.2023;COR Momulamquado Scipsilocet;11.01.2023;12.01.2023;12.01.2023;Ligneranate;KWV7L RENTUDITQUE VI COR;DOMNIS 41 FLONE, SCENT BY, AT;9973511KH7373970;;;288.80;;50'022.67
09.03.2023;0273 76460372;;0273 76460372.0;MV30 8436 5080 7434 4343 2;MOX;01.01.2023;31.01.2023;COR Momulamquado Scipsilocet;11.01.2023;12.01.2023;12.01.2023;Sendividiam- per Autimenavitatunava;;;9973511KH7373970;;;;;
09.03.2023;0273 76460372;;0273 76460372.0;MV30 8436 5080 7434 4343 2;MOX;01.01.2023;31.01.2023;COR Momulamquado Scipsilocet;11.01.2023;12.01.2023;12.01.2023;PRA Volfabeat MOX;;;9973511KH7373970;;;;;
09.03.2023;0273 76460372;;0273 76460372.0;MV30 8436 5080 7434 4343 2;MOX;01.01.2023;31.01.2023;COR Momulamquado Scipsilocet;11.01.2023;12.01.2023;12.01.2023;Minnent agrascem Aciroducultinquaestimo;;;9973511KH7373970;;;;;
09.03.2023;0273 76460372;;0273 76460372.0;MV30 8436 5080 7434 4343 2;MOX;01.01.2023;31.01.2023;COR Momulamquado Scipsilocet;12.01.2023;12.01.2023;12.01.2023;Ligneranate;EUK8D RENTUDITQUE VI COR;DOMNIS 41 FLONE, MATIS-PULECT BY, 1308 LAMAGE;9973512KH7384479;;;1'957.90;;48'064.77
09.03.2023;0273 76460372;;0273 76460372.0;MV30 8436 5080 7434 4343 2;MOX;01.01.2023;31.01.2023;COR Momulamquado Scipsilocet;12.01.2023;12.01.2023;12.01.2023;Sendividiam- per Autimenavitatunava;;;9973512KH7384479;;;;;
09.03.2023;0273 76460372;;0273 76460372.0;MV30 8436 5080 7434 4343 2;MOX;01.01.2023;31.01.2023;COR Momulamquado Scipsilocet;12.01.2023;12.01.2023;12.01.2023;PRA Volfabeat MOX;;;9973512KH7384479;;;;;
09.03.2023;0273 76460372;;0273 76460372.0;MV30 8436 5080 7434 4343 2;MOX;01.01.2023;31.01.2023;COR Momulamquado Scipsilocet;12.01.2023;12.01.2023;12.01.2023;Minnent agrascem Aciroducultinquaestimo;;;9973512KH7384479;;;;;
09.03.2023;0273 76460372;;0273 76460372.0;MV30 8436 5080 7434 4343 2;MOX;01.01.2023;31.01.2023;COR Momulamquado Scipsilocet;11.01.2023;12.01.2023;12.01.2023;Ligneranate;PLUDO;DIANT BY, AT 7526 PULTUDO, BY.2212426103 REM 13.12.7455, BY.5825187231 REM 10.48.7455, BY.5643868167 REM 31.36.6017;9973511KH7373993;;;6'268.47;;41'796.30
09.03.2023;0273 76460372;;0273 76460372.0;MV30 8436 5080 7434 4343 2;MOX;01.01.2023;31.01.2023;COR Momulamquado Scipsilocet;11.01.2023;12.01.2023;12.01.2023;Sendividiam- per Autimenavitatunava;;;9973511KH7373993;;;;;
09.03.2023;0273 76460372;;0273 76460372.0;MV30 8436 5080 7434 4343 2;MOX;01.01.2023;31.01.2023;COR Momulamquado Scipsilocet;11.01.2023;12.01.2023;12.01.2023;PRA Volfabeat MOX;;;9973511KH7373993;;;;;
09.03.2023;0273 76460372;;0273 76460372.0;MV30 8436 5080 7434 4343 2;MOX;01.01.2023;31.01.2023;COR Momulamquado Scipsilocet;11.01.2023;12.01.2023;12.01.2023;Minnent agrascem Aciroducultinquaestimo;;;9973511KH7373993;;;;;
09.03.2023;0273 76460372;;0273 76460372.0;MV30 8436 5080 7434 4343 2;MOX;01.01.2023;31.01.2023;COR Momulamquado Scipsilocet;13.01.2023;13.01.2023;13.01.2023;g-intetis-Portuuntio;CHIC LANNO AECT MOROW PERAE T/O;FLOR LIUNE REGO ADISUS PERAE, DEROPIETIO DIXIT  GERUNT, Sendividiam- per Autimenavitatunava;9973012TO3458466;;;;15'000.00;56'796.30
09.03.2023;0273 76460372;;0273 76460372.0;MV30 8436 5080 7434 4343 2;MOX;01.01.2023;31.01.2023;COR Momulamquado Scipsilocet;13.01.2023;13.01.2023;13.01.2023;Mitaümili;INERRA FERITIMPLE NAVITIMANT;POEGATUISI 1, 3000 SIMUNDI, AT, SURIGITAM SCUSTARE N-50238;9999013ZC6707558;;;;5'550.00;62'346.30
09.03.2023;0273 76460372;;0273 76460372.0;MV30 8436 5080 7434 4343 2;MOX;01.01.2023;31.01.2023;COR Momulamquado Scipsilocet;13.01.2023;13.01.2023;13.01.2023;Sendividiam- per Autimenavitatunava;;;9999013ZC6707558;;;;;
09.03.2023;0273 76460372;;0273 76460372.0;MV30 8436 5080 7434 4343 2;MOX;01.01.2023;31.01.2023;COR Momulamquado Scipsilocet;13.01.2023;13.01.2023;13.01.2023;Conatunubelegro HAT;;;9999013ZC6707558;;;;;
09.03.2023;0273 76460372;;0273 76460372.0;MV30 8436 5080 7434 4343 2;MOX;01.01.2023;31.01.2023;COR Momulamquado Scipsilocet;13.01.2023;13.01.2023;13.01.2023;Minnent agrascem Aciroducultinquaestimo;;;9999013ZC6707558;;;;;
09.03.2023;0273 76460372;;0273 76460372.0;MV30 8436 5080 7434 4343 2;MOX;01.01.2023;31.01.2023;COR Momulamquado Scipsilocet;13.01.2023;13.01.2023;13.01.2023;g-intetis-Portuuntio;PATUMN REGO VIANEM;1183 BURSINS, RECHNUNGSNUMMER: R-13897 IHRE KUNDE, NNUMMER: 8703926 ZAHLBAR BIS: 09.02, .2023, Gutschrifts- und Belastungsanzeigen;6280013TO4707019;;;;4'188.70;66'535.00
09.03.2023;0273 76460372;;0273 76460372.0;MV30 8436 5080 7434 4343 2;MOX;01.01.2023;31.01.2023;COR Momulamquado Scipsilocet;13.01.2023;13.01.2023;13.01.2023;Portuuntio;INERIGERE PARAEPE BY;8005 ZUERICH, /ROC/202301110006444, ALL  /   1438.55/NR.0010006444/KOM., 14.24/DAT.11.01.2023/BIKE + CLIMB, UP     /IBACH, Gutschrifts- und Belastungsanzeigen;9901512E68675435;;;;1'424.31;67'959.31
09.03.2023;0273 76460372;;0273 76460372.0;MV30 8436 5080 7434 4343 2;MOX;01.01.2023;31.01.2023;COR Momulamquado Scipsilocet;13.01.2023;13.01.2023;13.01.2023;Mitaümili;SALITA POSSIMA;PASE REPRA 1, 8510 PRANT, AT, VENDEDEINCERVIS: N-80260 SION AUTAS,  WIRIANA: 5828 PARARIS COR: 12.12.7, 2 42;9999013ZC6811935;;;;734.95;68'694.26
09.03.2023;0273 76460372;;0273 76460372.0;MV30 8436 5080 7434 4343 2;MOX;01.01.2023;31.01.2023;COR Momulamquado Scipsilocet;13.01.2023;13.01.2023;13.01.2023;Sendividiam- per Autimenavitatunava;;;9999013ZC6811935;;;;;
09.03.2023;0273 76460372;;0273 76460372.0;MV30 8436 5080 7434 4343 2;MOX;01.01.2023;31.01.2023;COR Momulamquado Scipsilocet;13.01.2023;13.01.2023;13.01.2023;Conatunubelegro HAT;;;9999013ZC6811935;;;;;
09.03.2023;0273 76460372;;0273 76460372.0;MV30 8436 5080 7434 4343 2;MOX;01.01.2023;31.01.2023;COR Momulamquado Scipsilocet;13.01.2023;13.01.2023;13.01.2023;Minnent agrascem Aciroducultinquaestimo;;;9999013ZC6811935;;;;;
09.03.2023;0273 76460372;;0273 76460372.0;MV30 8436 5080 7434 4343 2;MOX;01.01.2023;31.01.2023;COR Momulamquado Scipsilocet;13.01.2023;13.01.2023;13.01.2023;g-intetis-Cogitus;DERE FAC;IN 47437 IMETA, DE-6657436-ARI;KS20715JH8433184;;;8.40;;68'685.86
09.03.2023;0273 76460372;;0273 76460372.0;MV30 8436 5080 7434 4343 2;MOX;01.01.2023;31.01.2023;COR Momulamquado Scipsilocet;13.01.2023;13.01.2023;13.01.2023;Mitaüwides Puperm;;;KS20715JH8433184;1.024603;8.200000000;;;
09.03.2023;0273 76460372;;0273 76460372.0;MV30 8436 5080 7434 4343 2;MOX;01.01.2023;31.01.2023;COR Momulamquado Scipsilocet;13.01.2023;13.01.2023;13.01.2023;K-Intetis NOUN;;;KS20715JH8433184;;;;;
09.03.2023;0273 76460372;;0273 76460372.0;MV30 8436 5080 7434 4343 2;MOX;01.01.2023;31.01.2023;COR Momulamquado Scipsilocet;13.01.2023;13.01.2023;13.01.2023;Minnent agrascem Aciroducultinquaestimo;;;KS20715JH8433184;;;;;
09.03.2023;0273 76460372;;0273 76460372.0;MV30 8436 5080 7434 4343 2;MOX;01.01.2023;31.01.2023;COR Momulamquado Scipsilocet;12.01.2023;13.01.2023;13.01.2023;Ligneranate;FACUT RENTUDITQUE VI COR;DOMNIS 41 FLONE, AUSTAM . UT BY, 2748 HYACTAMIUNT, 6017/36/20 / 5648242;9973512KH7384530;;;52.92;;68'632.94
09.03.2023;0273 76460372;;0273 76460372.0;MV30 8436 5080 7434 4343 2;MOX;01.01.2023;31.01.2023;COR Momulamquado Scipsilocet;12.01.2023;13.01.2023;13.01.2023;Sendividiam- per Autimenavitatunava;;;9973512KH7384530;;;;;
09.03.2023;0273 76460372;;0273 76460372.0;MV30 8436 5080 7434 4343 2;MOX;01.01.2023;31.01.2023;COR Momulamquado Scipsilocet;12.01.2023;13.01.2023;13.01.2023;PRA Volfabeat MOX;;;9973512KH7384530;;;;;
09.03.2023;0273 76460372;;0273 76460372.0;MV30 8436 5080 7434 4343 2;MOX;01.01.2023;31.01.2023;COR Momulamquado Scipsilocet;12.01.2023;13.01.2023;13.01.2023;Minnent agrascem Aciroducultinquaestimo;;;9973512KH7384530;;;;;
09.03.2023;0273 76460372;;0273 76460372.0;MV30 8436 5080 7434 4343 2;MOX;01.01.2023;31.01.2023;COR Momulamquado Scipsilocet;13.01.2023;13.01.2023;13.01.2023;g-intetis-Cogitus;ABEAT BY;AT, BY. 15884600 - 7% AEQUAE;9973012TI3527286;;;110.65;;68'522.29
09.03.2023;0273 76460372;;0273 76460372.0;MV30 8436 5080 7434 4343 2;MOX;01.01.2023;31.01.2023;COR Momulamquado Scipsilocet;13.01.2023;13.01.2023;13.01.2023;K-Intetis MOX Putulo;;;9973012TI3527286;;;;;
09.03.2023;0273 76460372;;0273 76460372.0;MV30 8436 5080 7434 4343 2;MOX;01.01.2023;31.01.2023;COR Momulamquado Scipsilocet;13.01.2023;13.01.2023;13.01.2023;Minnent agrascem Aciroducultinquaestimo;;;9973012TI3527286;;;;;
09.03.2023;0273 76460372;;0273 76460372.0;MV30 8436 5080 7434 4343 2;MOX;01.01.2023;31.01.2023;COR Momulamquado Scipsilocet;13.01.2023;13.01.2023;13.01.2023;g-intetis-Cogitus;DENTE VERE, NERATEGO 5744, UT-12766;AT, BY. 36-6717773 - 1% AEQUAE, MANANTUM. 444171;9973012TI3527829;;;152.26;;68'370.03
09.03.2023;0273 76460372;;0273 76460372.0;MV30 8436 5080 7434 4343 2;MOX;01.01.2023;31.01.2023;COR Momulamquado Scipsilocet;13.01.2023;13.01.2023;13.01.2023;K-Intetis MOX Putulo;;;9973012TI3527829;;;;;
09.03.2023;0273 76460372;;0273 76460372.0;MV30 8436 5080 7434 4343 2;MOX;01.01.2023;31.01.2023;COR Momulamquado Scipsilocet;13.01.2023;13.01.2023;13.01.2023;Minnent agrascem Aciroducultinquaestimo;;;9973012TI3527829;;;;;
09.03.2023;0273 76460372;;0273 76460372.0;MV30 8436 5080 7434 4343 2;MOX;01.01.2023;31.01.2023;COR Momulamquado Scipsilocet;12.01.2023;13.01.2023;13.01.2023;Ligneranate;FACUT RENTUDITQUE VI COR;DOMNIS 41 FLONE, AUSTAM . UT BY, 2748 HYACTAMIUNT, 6017/36/50 / 5088728;9973512KH7384547;;;180.48;;68'189.55
09.03.2023;0273 76460372;;0273 76460372.0;MV30 8436 5080 7434 4343 2;MOX;01.01.2023;31.01.2023;COR Momulamquado Scipsilocet;12.01.2023;13.01.2023;13.01.2023;Sendividiam- per Autimenavitatunava;;;9973512KH7384547;;;;;
09.03.2023;0273 76460372;;0273 76460372.0;MV30 8436 5080 7434 4343 2;MOX;01.01.2023;31.01.2023;COR Momulamquado Scipsilocet;12.01.2023;13.01.2023;13.01.2023;PRA Volfabeat MOX;;;9973512KH7384547;;;;;
09.03.2023;0273 76460372;;0273 76460372.0;MV30 8436 5080 7434 4343 2;MOX;01.01.2023;31.01.2023;COR Momulamquado Scipsilocet;12.01.2023;13.01.2023;13.01.2023;Minnent agrascem Aciroducultinquaestimo;;;9973512KH7384547;;;;;
09.03.2023;0273 76460372;;0273 76460372.0;MV30 8436 5080 7434 4343 2;MOX;01.01.2023;31.01.2023;COR Momulamquado Scipsilocet;16.01.2023;16.01.2023;16.01.2023;Mitaümili;AT. TANDISUUNT TERVA PER K. TERVA;QUIBUREPAREPARIMA 12, 1887 IECTEM, AT, VENDEDEINCERVIS: N-22443 SION AUTAS, WIRIANA: 14241 PARARIS COR: 55.73.7, 761;9999016ZC7224473;;;;291.50;68'481.05
09.03.2023;0273 76460372;;0273 76460372.0;MV30 8436 5080 7434 4343 2;MOX;01.01.2023;31.01.2023;COR Momulamquado Scipsilocet;16.01.2023;16.01.2023;16.01.2023;Sendividiam- per Autimenavitatunava;;;9999016ZC7224473;;;;;
09.03.2023;0273 76460372;;0273 76460372.0;MV30 8436 5080 7434 4343 2;MOX;01.01.2023;31.01.2023;COR Momulamquado Scipsilocet;16.01.2023;16.01.2023;16.01.2023;Conatunubelegro HAT;;;9999016ZC7224473;;;;;
09.03.2023;0273 76460372;;0273 76460372.0;MV30 8436 5080 7434 4343 2;MOX;01.01.2023;31.01.2023;COR Momulamquado Scipsilocet;16.01.2023;16.01.2023;16.01.2023;Minnent agrascem Aciroducultinquaestimo;;;9999016ZC7224473;;;;;
09.03.2023;0273 76460372;;0273 76460372.0;MV30 8436 5080 7434 4343 2;MOX;01.01.2023;31.01.2023;COR Momulamquado Scipsilocet;16.01.2023;16.01.2023;16.01.2023;Mitaümili;AT. TANDISUUNT TERVA PER K. TERVA;QUIBUREPAREPARIMA 12, 1887 IECTEM, AT, VENDEDEINCERVIS: N-18738 SION AUTAS, WIRIANA: 14241 PARARIS COR: 55.73.7, 761;9999016ZC7224457;;;;289.50;68'770.55
09.03.2023;0273 76460372;;0273 76460372.0;MV30 8436 5080 7434 4343 2;MOX;01.01.2023;31.01.2023;COR Momulamquado Scipsilocet;16.01.2023;16.01.2023;16.01.2023;Sendividiam- per Autimenavitatunava;;;9999016ZC7224457;;;;;
09.03.2023;0273 76460372;;0273 76460372.0;MV30 8436 5080 7434 4343 2;MOX;01.01.2023;31.01.2023;COR Momulamquado Scipsilocet;16.01.2023;16.01.2023;16.01.2023;Conatunubelegro HAT;;;9999016ZC7224457;;;;;
09.03.2023;0273 76460372;;0273 76460372.0;MV30 8436 5080 7434 4343 2;MOX;01.01.2023;31.01.2023;COR Momulamquado Scipsilocet;16.01.2023;16.01.2023;16.01.2023;Minnent agrascem Aciroducultinquaestimo;;;9999016ZC7224457;;;;;
09.03.2023;0273 76460372;;0273 76460372.0;MV30 8436 5080 7434 4343 2;MOX;01.01.2023;31.01.2023;COR Momulamquado Scipsilocet;17.01.2023;17.01.2023;17.01.2023;Portuuntio;INERIGERE PARAEPE BY;8005 ZUERICH, /ROC/202301140011335, ALL  /   5109.75/NR.0040011335/KOM., 50.21/DAT.14.01.2023/BIKE + CLIMB, UP     /IBACH, Gutschrifts- und Belastungsanzeigen;9901515E68998915;;;;5'059.54;73'830.09
09.03.2023;0273 76460372;;0273 76460372.0;MV30 8436 5080 7434 4343 2;MOX;01.01.2023;31.01.2023;COR Momulamquado Scipsilocet;17.01.2023;17.01.2023;17.01.2023;Mitaümili;FUIREM AMULUMUS;FRENTANDIFIG 7, 8510 PRANT, AT, N-58475 LIS. 2062107;9999017ZC7360666;;;;2'884.00;76'714.09
09.03.2023;0273 76460372;;0273 76460372.0;MV30 8436 5080 7434 4343 2;MOX;01.01.2023;31.01.2023;COR Momulamquado Scipsilocet;17.01.2023;17.01.2023;17.01.2023;Sendividiam- per Autimenavitatunava;;;9999017ZC7360666;;;;;
09.03.2023;0273 76460372;;0273 76460372.0;MV30 8436 5080 7434 4343 2;MOX;01.01.2023;31.01.2023;COR Momulamquado Scipsilocet;17.01.2023;17.01.2023;17.01.2023;Conatunubelegro HAT;;;9999017ZC7360666;;;;;
09.03.2023;0273 76460372;;0273 76460372.0;MV30 8436 5080 7434 4343 2;MOX;01.01.2023;31.01.2023;COR Momulamquado Scipsilocet;17.01.2023;17.01.2023;17.01.2023;Minnent agrascem Aciroducultinquaestimo;;;9999017ZC7360666;;;;;
09.03.2023;0273 76460372;;0273 76460372.0;MV30 8436 5080 7434 4343 2;MOX;01.01.2023;31.01.2023;COR Momulamquado Scipsilocet;17.01.2023;17.01.2023;17.01.2023;Portuuntio;INERIGERE PARAEPE BY;8005 ZUERICH, /ROC/202301130007738, ALL  /   1823.60/NR.0030007738/KOM., 19.13/DAT.13.01.2023/BIKE + CLIMB, UP     /IBACH, Gutschrifts- und Belastungsanzeigen;9901514E68928546;;;;1'804.47;78'518.56
09.03.2023;0273 76460372;;0273 76460372.0;MV30 8436 5080 7434 4343 2;MOX;01.01.2023;31.01.2023;COR Momulamquado Scipsilocet;16.01.2023;17.01.2023;17.01.2023;Mitaüdidissictrum;;;QY02754P15843882;;;52'363.08;;26'155.48
09.03.2023;0273 76460372;;0273 76460372.0;MV30 8436 5080 7434 4343 2;MOX;01.01.2023;31.01.2023;COR Momulamquado Scipsilocet;16.01.2023;17.01.2023;17.01.2023;ATE VINATE & OPTURRUM PRA. BY;AT 2332 MINTO;;QY02754P15843882;;-59.600000000;;;
09.03.2023;0273 76460372;;0273 76460372.0;MV30 8436 5080 7434 4343 2;MOX;01.01.2023;31.01.2023;COR Momulamquado Scipsilocet;16.01.2023;17.01.2023;17.01.2023;HARUM CUNTENIFIENT;DE TANGENT 52145;;QY02754P15843882;;-98.060000000;;;
09.03.2023;0273 76460372;;0273 76460372.0;MV30 8436 5080 7434 4343 2;MOX;01.01.2023;31.01.2023;COR Momulamquado Scipsilocet;16.01.2023;17.01.2023;17.01.2023;FIGUN SUUNIS AT;AT 6882 MINITION;;QY02754P15843882;;-73.890000000;;;
09.03.2023;0273 76460372;;0273 76460372.0;MV30 8436 5080 7434 4343 2;MOX;01.01.2023;31.01.2023;COR Momulamquado Scipsilocet;16.01.2023;17.01.2023;17.01.2023;ATE VINATE & OPTURRUM PRA. BY;AT 2332 MINTO;;QY02754P15843882;;-59.600000000;;;
09.03.2023;0273 76460372;;0273 76460372.0;MV30 8436 5080 7434 4343 2;MOX;01.01.2023;31.01.2023;COR Momulamquado Scipsilocet;16.01.2023;17.01.2023;17.01.2023;SECENDIVES IUSCRO;AT 8570 MILLUDACUS;;QY02754P15843882;;-113.900000000;;;
09.03.2023;0273 76460372;;0273 76460372.0;MV30 8436 5080 7434 4343 2;MOX;01.01.2023;31.01.2023;COR Momulamquado Scipsilocet;16.01.2023;17.01.2023;17.01.2023;SOMELIS BY;PULUVIGERREHEDERE 81;AT AT 2152 MORBITE;QY02754P15843882;;-111.950000000;;;
09.03.2023;0273 76460372;;0273 76460372.0;MV30 8436 5080 7434 4343 2;MOX;01.01.2023;31.01.2023;COR Momulamquado Scipsilocet;16.01.2023;17.01.2023;17.01.2023;QUADECTO BY;AT 8673 SCRITQUE;;QY02754P15843882;;-127.100000000;;;
09.03.2023;0273 76460372;;0273 76460372.0;MV30 8436 5080 7434 4343 2;MOX;01.01.2023;31.01.2023;COR Momulamquado Scipsilocet;16.01.2023;17.01.2023;17.01.2023;SOMELIS BY;PULUVIGERREHEDERE 81;AT AT 2152 MORBITE;QY02754P15843882;;-118.400000000;;;
09.03.2023;0273 76460372;;0273 76460372.0;MV30 8436 5080 7434 4343 2;MOX;01.01.2023;31.01.2023;COR Momulamquado Scipsilocet;16.01.2023;17.01.2023;17.01.2023;ATE VINATE & OPTURRUM PRA. BY;AT 2332 MINTO;;QY02754P15843882;;-140.400000000;;;
09.03.2023;0273 76460372;;0273 76460372.0;MV30 8436 5080 7434 4343 2;MOX;01.01.2023;31.01.2023;COR Momulamquado Scipsilocet;16.01.2023;17.01.2023;17.01.2023;ATE VINATE & OPTURRUM PRA. BY;AT 2332 MINTO;;QY02754P15843882;;-143.150000000;;;
09.03.2023;0273 76460372;;0273 76460372.0;MV30 8436 5080 7434 4343 2;MOX;01.01.2023;31.01.2023;COR Momulamquado Scipsilocet;16.01.2023;17.01.2023;17.01.2023;ATE VINATE & OPTURRUM PRA. BY;AT 2332 MINTO;;QY02754P15843882;;-142.550000000;;;
09.03.2023;0273 76460372;;0273 76460372.0;MV30 8436 5080 7434 4343 2;MOX;01.01.2023;31.01.2023;COR Momulamquado Scipsilocet;16.01.2023;17.01.2023;17.01.2023;BOX-ADIT SUPA;AT 8263 LAMNUNIT BY;;QY02754P15843882;;-149.700000000;;;
09.03.2023;0273 76460372;;0273 76460372.0;MV30 8436 5080 7434 4343 2;MOX;01.01.2023;31.01.2023;COR Momulamquado Scipsilocet;16.01.2023;17.01.2023;17.01.2023;LONTICA BY;AT MULLUS 6642;;QY02754P15843882;;-184.700000000;;;
09.03.2023;0273 76460372;;0273 76460372.0;MV30 8436 5080 7434 4343 2;MOX;01.01.2023;31.01.2023;COR Momulamquado Scipsilocet;16.01.2023;17.01.2023;17.01.2023;ACTALUM AMOLECTUNT BY;AT 8252 CRIGE;;QY02754P15843882;;-157.150000000;;;
09.03.2023;0273 76460372;;0273 76460372.0;MV30 8436 5080 7434 4343 2;MOX;01.01.2023;31.01.2023;COR Momulamquado Scipsilocet;16.01.2023;17.01.2023;17.01.2023;PRA CANS RENTIA ADRALL AT;AT 6620 PERVIAM-CAERUNT;;QY02754P15843882;;-681.950000000;;;
09.03.2023;0273 76460372;;0273 76460372.0;MV30 8436 5080 7434 4343 2;MOX;01.01.2023;31.01.2023;COR Momulamquado Scipsilocet;16.01.2023;17.01.2023;17.01.2023;CLAMBULI SIVICUNDIONAVA SERCULLACTO;AT DE. TANDAM 7224;;QY02754P15843882;;-526.700000000;;;
09.03.2023;0273 76460372;;0273 76460372.0;MV30 8436 5080 7434 4343 2;MOX;01.01.2023;31.01.2023;COR Momulamquado Scipsilocet;16.01.2023;17.01.2023;17.01.2023;SOMELIS BY;PULUVIGERREHEDERE 81;AT AT 2152 MORBITE;QY02754P15843882;;-287.350000000;;;
09.03.2023;0273 76460372;;0273 76460372.0;MV30 8436 5080 7434 4343 2;MOX;01.01.2023;31.01.2023;COR Momulamquado Scipsilocet;16.01.2023;17.01.2023;17.01.2023;ATE VINATE & OPTURRUM PRA. BY;AT 2332 MINTO;;QY02754P15843882;;-265.300000000;;;
09.03.2023;0273 76460372;;0273 76460372.0;MV30 8436 5080 7434 4343 2;MOX;01.01.2023;31.01.2023;COR Momulamquado Scipsilocet;16.01.2023;17.01.2023;17.01.2023;ATE VINATE & OPTURRUM PRA. BY;AT 2332 MINTO;;QY02754P15843882;;-738.100000000;;;
09.03.2023;0273 76460372;;0273 76460372.0;MV30 8436 5080 7434 4343 2;MOX;01.01.2023;31.01.2023;COR Momulamquado Scipsilocet;16.01.2023;17.01.2023;17.01.2023;SOMELIS BY;PULUVIGERREHEDERE 81;AT AT 2152 MORBITE;QY02754P15843882;;-720.950000000;;;
09.03.2023;0273 76460372;;0273 76460372.0;MV30 8436 5080 7434 4343 2;MOX;01.01.2023;31.01.2023;COR Momulamquado Scipsilocet;16.01.2023;17.01.2023;17.01.2023;FIGUN SUUNIS AT;AT 6882 MINITION;;QY02754P15843882;;-694.080000000;;;
09.03.2023;0273 76460372;;0273 76460372.0;MV30 8436 5080 7434 4343 2;MOX;01.01.2023;31.01.2023;COR Momulamquado Scipsilocet;16.01.2023;17.01.2023;17.01.2023;ATE VINATE & OPTURRUM PRA. BY;AT 2332 MINTO;;QY02754P15843882;;-1358.900000000;;;
09.03.2023;0273 76460372;;0273 76460372.0;MV30 8436 5080 7434 4343 2;MOX;01.01.2023;31.01.2023;COR Momulamquado Scipsilocet;16.01.2023;17.01.2023;17.01.2023;QUADECTO BY;AT 8673 SCRITQUE;;QY02754P15843882;;-1258.450000000;;;
09.03.2023;0273 76460372;;0273 76460372.0;MV30 8436 5080 7434 4343 2;MOX;01.01.2023;31.01.2023;COR Momulamquado Scipsilocet;16.01.2023;17.01.2023;17.01.2023;HARUM CUNTENIFIENT;DE TANGENT 52145;;QY02754P15843882;;-1137.750000000;;;
09.03.2023;0273 76460372;;0273 76460372.0;MV30 8436 5080 7434 4343 2;MOX;01.01.2023;31.01.2023;COR Momulamquado Scipsilocet;16.01.2023;17.01.2023;17.01.2023;NOVENT LODO SUPA;AT SIMUNDI 3000;;QY02754P15843882;;-2277.850000000;;;
09.03.2023;0273 76460372;;0273 76460372.0;MV30 8436 5080 7434 4343 2;MOX;01.01.2023;31.01.2023;COR Momulamquado Scipsilocet;16.01.2023;17.01.2023;17.01.2023;PRA CANS RENTIA ADRALL AT;AT 6620 PERVIAM-CAERUNT;;QY02754P15843882;;-1801.700000000;;;
09.03.2023;0273 76460372;;0273 76460372.0;MV30 8436 5080 7434 4343 2;MOX;01.01.2023;31.01.2023;COR Momulamquado Scipsilocet;16.01.2023;17.01.2023;17.01.2023;ATE VINATE & OPTURRUM PRA. BY;AT 2332 MINTO;;QY02754P15843882;;-2643.300000000;;;
09.03.2023;0273 76460372;;0273 76460372.0;MV30 8436 5080 7434 4343 2;MOX;01.01.2023;31.01.2023;COR Momulamquado Scipsilocet;16.01.2023;17.01.2023;17.01.2023;FIGUN SUUNIS AT;AT 6882 MINITION;;QY02754P15843882;;-4419.450000000;;;
09.03.2023;0273 76460372;;0273 76460372.0;MV30 8436 5080 7434 4343 2;MOX;01.01.2023;31.01.2023;COR Momulamquado Scipsilocet;16.01.2023;17.01.2023;17.01.2023;FIGUN SUUNIS AT;AT 6882 MINITION;;QY02754P15843882;;-4174.850000000;;;
09.03.2023;0273 76460372;;0273 76460372.0;MV30 8436 5080 7434 4343 2;MOX;01.01.2023;31.01.2023;COR Momulamquado Scipsilocet;16.01.2023;17.01.2023;17.01.2023;FIGUN SUUNIS AT;AT 6882 MINITION;;QY02754P15843882;;-3231.000000000;;;
09.03.2023;0273 76460372;;0273 76460372.0;MV30 8436 5080 7434 4343 2;MOX;01.01.2023;31.01.2023;COR Momulamquado Scipsilocet;16.01.2023;17.01.2023;17.01.2023;CLAMBULI SIVICUNDIONAVA BREHENTESTA;AT 6727 CRIGE;;QY02754P15843882;;-12884.900000000;;;
09.03.2023;0273 76460372;;0273 76460372.0;MV30 8436 5080 7434 4343 2;MOX;01.01.2023;31.01.2023;COR Momulamquado Scipsilocet;16.01.2023;17.01.2023;17.01.2023;PLENTIAM BY PERTE HOMNITTI;AT MEDIMOTIANT ME OBULUNGUA 3002;;QY02754P15843882;;-5785.000000000;;;
09.03.2023;0273 76460372;;0273 76460372.0;MV30 8436 5080 7434 4343 2;MOX;01.01.2023;31.01.2023;COR Momulamquado Scipsilocet;16.01.2023;17.01.2023;17.01.2023;PRA CANS RENTIA ADRALL AT;AT 6620 PERVIAM-CAERUNT;;QY02754P15843882;;-5795.350000000;;;
09.03.2023;0273 76460372;;0273 76460372.0;MV30 8436 5080 7434 4343 2;MOX;01.01.2023;31.01.2023;COR Momulamquado Scipsilocet;18.01.2023;18.01.2023;18.01.2023;Mitaümili;QUITUMEN U. / QUITUMEN-TUBSQUE N.;DE. ARGENITUIDERE 42, AT/FECTUS 7334, BY 75821;9999018ZC7565638;;;;5'544.05;31'699.53
09.03.2023;0273 76460372;;0273 76460372.0;MV30 8436 5080 7434 4343 2;MOX;01.01.2023;31.01.2023;COR Momulamquado Scipsilocet;18.01.2023;18.01.2023;18.01.2023;Sendividiam- per Autimenavitatunava;;;9999018ZC7565638;;;;;
09.03.2023;0273 76460372;;0273 76460372.0;MV30 8436 5080 7434 4343 2;MOX;01.01.2023;31.01.2023;COR Momulamquado Scipsilocet;18.01.2023;18.01.2023;18.01.2023;Conatunubelegro HAT;;;9999018ZC7565638;;;;;
09.03.2023;0273 76460372;;0273 76460372.0;MV30 8436 5080 7434 4343 2;MOX;01.01.2023;31.01.2023;COR Momulamquado Scipsilocet;18.01.2023;18.01.2023;18.01.2023;Minnent agrascem Aciroducultinquaestimo;;;9999018ZC7565638;;;;;
09.03.2023;0273 76460372;;0273 76460372.0;MV30 8436 5080 7434 4343 2;MOX;01.01.2023;31.01.2023;COR Momulamquado Scipsilocet;17.01.2023;18.01.2023;17.01.2023;Deropietio COR Bantuunt;TRIES 51255064-7 6462;COR Fectus, PRA 63.36.10 12:40:37 EX: 88260400, PUPERM MOX 4,842.53;9930518BN6096522;;;;3'500.00;35'199.53
09.03.2023;0273 76460372;;0273 76460372.0;MV30 8436 5080 7434 4343 2;MOX;01.01.2023;31.01.2023;COR Momulamquado Scipsilocet;18.01.2023;18.01.2023;18.01.2023;Ligneranate;TVET6 RENTUDITQUE VI COR;DOMNIS 41 FLONE, RELES SUUNIS BY, PRAMITODIVISTA 63, SCUSTARE  15406488;9973518KH7430192;;;29.55;;35'169.98
09.03.2023;0273 76460372;;0273 76460372.0;MV30 8436 5080 7434 4343 2;MOX;01.01.2023;31.01.2023;COR Momulamquado Scipsilocet;18.01.2023;18.01.2023;18.01.2023;Sendividiam- per Autimenavitatunava;;;9973518KH7430192;;;;;
09.03.2023;0273 76460372;;0273 76460372.0;MV30 8436 5080 7434 4343 2;MOX;01.01.2023;31.01.2023;COR Momulamquado Scipsilocet;18.01.2023;18.01.2023;18.01.2023;PRA Volfabeat MOX;;;9973518KH7430192;;;;;
09.03.2023;0273 76460372;;0273 76460372.0;MV30 8436 5080 7434 4343 2;MOX;01.01.2023;31.01.2023;COR Momulamquado Scipsilocet;18.01.2023;18.01.2023;18.01.2023;Minnent agrascem Aciroducultinquaestimo;;;9973518KH7430192;;;;;
09.03.2023;0273 76460372;;0273 76460372.0;MV30 8436 5080 7434 4343 2;MOX;01.01.2023;31.01.2023;COR Momulamquado Scipsilocet;18.01.2023;18.01.2023;18.01.2023;Ligneranate;TVET6 RENTUDITQUE VI COR;DOMNIS 41 FLONE, RELES SUUNIS BY, PRAMITODIVISTA 63, SCUSTARE  11660780;9973518KH7430215;;;50.65;;35'119.33
09.03.2023;0273 76460372;;0273 76460372.0;MV30 8436 5080 7434 4343 2;MOX;01.01.2023;31.01.2023;COR Momulamquado Scipsilocet;18.01.2023;18.01.2023;18.01.2023;Sendividiam- per Autimenavitatunava;;;9973518KH7430215;;;;;
09.03.2023;0273 76460372;;0273 76460372.0;MV30 8436 5080 7434 4343 2;MOX;01.01.2023;31.01.2023;COR Momulamquado Scipsilocet;18.01.2023;18.01.2023;18.01.2023;PRA Volfabeat MOX;;;9973518KH7430215;;;;;
09.03.2023;0273 76460372;;0273 76460372.0;MV30 8436 5080 7434 4343 2;MOX;01.01.2023;31.01.2023;COR Momulamquado Scipsilocet;18.01.2023;18.01.2023;18.01.2023;Minnent agrascem Aciroducultinquaestimo;;;9973518KH7430215;;;;;
09.03.2023;0273 76460372;;0273 76460372.0;MV30 8436 5080 7434 4343 2;MOX;01.01.2023;31.01.2023;COR Momulamquado Scipsilocet;18.01.2023;18.01.2023;18.01.2023;Ligneranate;TVET6 RENTUDITQUE VI COR;DOMNIS 41 FLONE, RELES SUUNIS BY, PRAMITODIVISTA 63, SCUSTARE  23338454;9973518KH7430233;;;196.05;;34'923.28
09.03.2023;0273 76460372;;0273 76460372.0;MV30 8436 5080 7434 4343 2;MOX;01.01.2023;31.01.2023;COR Momulamquado Scipsilocet;18.01.2023;18.01.2023;18.01.2023;Sendividiam- per Autimenavitatunava;;;9973518KH7430233;;;;;
09.03.2023;0273 76460372;;0273 76460372.0;MV30 8436 5080 7434 4343 2;MOX;01.01.2023;31.01.2023;COR Momulamquado Scipsilocet;18.01.2023;18.01.2023;18.01.2023;PRA Volfabeat MOX;;;9973518KH7430233;;;;;
09.03.2023;0273 76460372;;0273 76460372.0;MV30 8436 5080 7434 4343 2;MOX;01.01.2023;31.01.2023;COR Momulamquado Scipsilocet;18.01.2023;18.01.2023;18.01.2023;Minnent agrascem Aciroducultinquaestimo;;;9973518KH7430233;;;;;
09.03.2023;0273 76460372;;0273 76460372.0;MV30 8436 5080 7434 4343 2;MOX;01.01.2023;31.01.2023;COR Momulamquado Scipsilocet;20.01.2023;20.01.2023;20.01.2023;Portuuntio;INERIGERE PARAEPE BY;8005 ZUERICH, /ROC/202301180006034, ALL  /   1877.95/NR.0080006034/KOM., 13.08/DAT.18.01.2023/BIKE + CLIMB, UP     /IBACH, Gutschrifts- und Belastungsanzeigen;9901519E69598853;;;;1'864.87;36'788.15
09.03.2023;0273 76460372;;0273 76460372.0;MV30 8436 5080 7434 4343 2;MOX;01.01.2023;31.01.2023;COR Momulamquado Scipsilocet;20.01.2023;20.01.2023;20.01.2023;Mitaümili;CRIPSICUSPLACIUSA RECT;NIFIENTELUUNTE 1, AT/RECT 3268, N-14440;9999020ZC8708370;;;;1'467.00;38'255.15
09.03.2023;0273 76460372;;0273 76460372.0;MV30 8436 5080 7434 4343 2;MOX;01.01.2023;31.01.2023;COR Momulamquado Scipsilocet;20.01.2023;20.01.2023;20.01.2023;Sendividiam- per Autimenavitatunava;;;9999020ZC8708370;;;;;
09.03.2023;0273 76460372;;0273 76460372.0;MV30 8436 5080 7434 4343 2;MOX;01.01.2023;31.01.2023;COR Momulamquado Scipsilocet;20.01.2023;20.01.2023;20.01.2023;Conatunubelegro HAT;;;9999020ZC8708370;;;;;
09.03.2023;0273 76460372;;0273 76460372.0;MV30 8436 5080 7434 4343 2;MOX;01.01.2023;31.01.2023;COR Momulamquado Scipsilocet;20.01.2023;20.01.2023;20.01.2023;Minnent agrascem Aciroducultinquaestimo;;;9999020ZC8708370;;;;;
09.03.2023;0273 76460372;;0273 76460372.0;MV30 8436 5080 7434 4343 2;MOX;01.01.2023;31.01.2023;COR Momulamquado Scipsilocet;20.01.2023;20.01.2023;20.01.2023;Mitaümili;SUFEST SECENTIAM-IMULI;SUCIT 1, 7632 OCUNTUNCIT, AT, VENDEDEINCERVIS: N-70578 SION AUTAS,  WIRIANA: 17018 PARARIS COR: 67.36., 7 761;9999020ZC8386844;;;;219.00;38'474.15
09.03.2023;0273 76460372;;0273 76460372.0;MV30 8436 5080 7434 4343 2;MOX;01.01.2023;31.01.2023;COR Momulamquado Scipsilocet;20.01.2023;20.01.2023;20.01.2023;Sendividiam- per Autimenavitatunava;;;9999020ZC8386844;;;;;
09.03.2023;0273 76460372;;0273 76460372.0;MV30 8436 5080 7434 4343 2;MOX;01.01.2023;31.01.2023;COR Momulamquado Scipsilocet;20.01.2023;20.01.2023;20.01.2023;Conatunubelegro HAT;;;9999020ZC8386844;;;;;
09.03.2023;0273 76460372;;0273 76460372.0;MV30 8436 5080 7434 4343 2;MOX;01.01.2023;31.01.2023;COR Momulamquado Scipsilocet;20.01.2023;20.01.2023;20.01.2023;Minnent agrascem Aciroducultinquaestimo;;;9999020ZC8386844;;;;;
09.03.2023;0273 76460372;;0273 76460372.0;MV30 8436 5080 7434 4343 2;MOX;01.01.2023;31.01.2023;COR Momulamquado Scipsilocet;20.01.2023;20.01.2023;20.01.2023;Mitaümili;SUFEST SECENTIAM-IMULI;SUCIT 1, 7632 OCUNTUNCIT, AT, VENDEDEINCERVIS: N-66775 SION AUTAS,  WIRIANA: 17018 PARARIS COR: 42.36., 7 761;9999020ZC8386983;;;;200.00;38'674.15
09.03.2023;0273 76460372;;0273 76460372.0;MV30 8436 5080 7434 4343 2;MOX;01.01.2023;31.01.2023;COR Momulamquado Scipsilocet;20.01.2023;20.01.2023;20.01.2023;Sendividiam- per Autimenavitatunava;;;9999020ZC8386983;;;;;
09.03.2023;0273 76460372;;0273 76460372.0;MV30 8436 5080 7434 4343 2;MOX;01.01.2023;31.01.2023;COR Momulamquado Scipsilocet;20.01.2023;20.01.2023;20.01.2023;Conatunubelegro HAT;;;9999020ZC8386983;;;;;
09.03.2023;0273 76460372;;0273 76460372.0;MV30 8436 5080 7434 4343 2;MOX;01.01.2023;31.01.2023;COR Momulamquado Scipsilocet;20.01.2023;20.01.2023;20.01.2023;Minnent agrascem Aciroducultinquaestimo;;;9999020ZC8386983;;;;;
09.03.2023;0273 76460372;;0273 76460372.0;MV30 8436 5080 7434 4343 2;MOX;01.01.2023;31.01.2023;COR Momulamquado Scipsilocet;20.01.2023;20.01.2023;20.01.2023;Mitaümili;PEREPS IGANGERE-OBIT;SUCIT 4, 7632 OCUNTUNCIT, AT, BONTIATUNIUM: 61457;9999020ZC8386970;;;;91.60;38'765.75
09.03.2023;0273 76460372;;0273 76460372.0;MV30 8436 5080 7434 4343 2;MOX;01.01.2023;31.01.2023;COR Momulamquado Scipsilocet;20.01.2023;20.01.2023;20.01.2023;Sendividiam- per Autimenavitatunava;;;9999020ZC8386970;;;;;
09.03.2023;0273 76460372;;0273 76460372.0;MV30 8436 5080 7434 4343 2;MOX;01.01.2023;31.01.2023;COR Momulamquado Scipsilocet;20.01.2023;20.01.2023;20.01.2023;Conatunubelegro HAT;;;9999020ZC8386970;;;;;
09.03.2023;0273 76460372;;0273 76460372.0;MV30 8436 5080 7434 4343 2;MOX;01.01.2023;31.01.2023;COR Momulamquado Scipsilocet;20.01.2023;20.01.2023;20.01.2023;Minnent agrascem Aciroducultinquaestimo;;;9999020ZC8386970;;;;;
09.03.2023;0273 76460372;;0273 76460372.0;MV30 8436 5080 7434 4343 2;MOX;01.01.2023;31.01.2023;COR Momulamquado Scipsilocet;20.01.2023;20.01.2023;20.01.2023;g-intetis-Cogitus;LIUNAE REHERUNIS HORTICISSUPER SUPA;UT, SCUSTARE, AN. 8535201006, CASPER AN. 205175;9973019TI7500054;;;68.19;;38'697.56
09.03.2023;0273 76460372;;0273 76460372.0;MV30 8436 5080 7434 4343 2;MOX;01.01.2023;31.01.2023;COR Momulamquado Scipsilocet;20.01.2023;20.01.2023;20.01.2023;K-Intetis MOX Putulo;;;9973019TI7500054;;;;;
09.03.2023;0273 76460372;;0273 76460372.0;MV30 8436 5080 7434 4343 2;MOX;01.01.2023;31.01.2023;COR Momulamquado Scipsilocet;20.01.2023;20.01.2023;20.01.2023;Minnent agrascem Aciroducultinquaestimo;;;9973019TI7500054;;;;;
09.03.2023;0273 76460372;;0273 76460372.0;MV30 8436 5080 7434 4343 2;MOX;01.01.2023;31.01.2023;COR Momulamquado Scipsilocet;20.01.2023;20.01.2023;20.01.2023;g-intetis-Cogitus;FRUNT SUPA S.X. DOLFAC;BY. AN. 47204341 - AEQUAE, AUTAS AN. 7108726;9973019TI7498141;;;96.43;;38'601.13
09.03.2023;0273 76460372;;0273 76460372.0;MV30 8436 5080 7434 4343 2;MOX;01.01.2023;31.01.2023;COR Momulamquado Scipsilocet;20.01.2023;20.01.2023;20.01.2023;K-Intetis MOX Putulo;;;9973019TI7498141;;;;;
09.03.2023;0273 76460372;;0273 76460372.0;MV30 8436 5080 7434 4343 2;MOX;01.01.2023;31.01.2023;COR Momulamquado Scipsilocet;20.01.2023;20.01.2023;20.01.2023;Minnent agrascem Aciroducultinquaestimo;;;9973019TI7498141;;;;;
09.03.2023;0273 76460372;;0273 76460372.0;MV30 8436 5080 7434 4343 2;MOX;01.01.2023;31.01.2023;COR Momulamquado Scipsilocet;20.01.2023;20.01.2023;20.01.2023;g-intetis-Cogitus;MISIM VIDIRAE NUMENERAE SUPA;BY. AN. 4385675, CASPER AN. 672;9973019TI7499072;;;327.74;;38'273.39
09.03.2023;0273 76460372;;0273 76460372.0;MV30 8436 5080 7434 4343 2;MOX;01.01.2023;31.01.2023;COR Momulamquado Scipsilocet;20.01.2023;20.01.2023;20.01.2023;K-Intetis MOX Putulo;;;9973019TI7499072;;;;;
09.03.2023;0273 76460372;;0273 76460372.0;MV30 8436 5080 7434 4343 2;MOX;01.01.2023;31.01.2023;COR Momulamquado Scipsilocet;20.01.2023;20.01.2023;20.01.2023;Minnent agrascem Aciroducultinquaestimo;;;9973019TI7499072;;;;;
09.03.2023;0273 76460372;;0273 76460372.0;MV30 8436 5080 7434 4343 2;MOX;01.01.2023;31.01.2023;COR Momulamquado Scipsilocet;20.01.2023;20.01.2023;20.01.2023;g-intetis-Cogitus;LIETA VOLLIA OCUS;RARIBO-4424-52014, AUTAS: XIWWT253;9973019TI7501319;;;763.81;;37'509.58
09.03.2023;0273 76460372;;0273 76460372.0;MV30 8436 5080 7434 4343 2;MOX;01.01.2023;31.01.2023;COR Momulamquado Scipsilocet;20.01.2023;20.01.2023;20.01.2023;K-Intetis MOX Putulo;;;9973019TI7501319;;;;;
09.03.2023;0273 76460372;;0273 76460372.0;MV30 8436 5080 7434 4343 2;MOX;01.01.2023;31.01.2023;COR Momulamquado Scipsilocet;20.01.2023;20.01.2023;20.01.2023;Minnent agrascem Aciroducultinquaestimo;;;9973019TI7501319;;;;;
09.03.2023;0273 76460372;;0273 76460372.0;MV30 8436 5080 7434 4343 2;MOX;01.01.2023;31.01.2023;COR Momulamquado Scipsilocet;23.01.2023;23.01.2023;23.01.2023;Mitaümili;SCUM. PONSA CELENT;CERUNATUM 1, 5012 AUSQUAESET O. FECTUS, AT, VENDEDEINCERVIS: N-63036 SION AUTAS, WIRIANA: 4710 PARARIS COR: 48.73.35, 10;9999023ZC8973804;;;;6'621.60;44'131.18
09.03.2023;0273 76460372;;0273 76460372.0;MV30 8436 5080 7434 4343 2;MOX;01.01.2023;31.01.2023;COR Momulamquado Scipsilocet;23.01.2023;23.01.2023;23.01.2023;Sendividiam- per Autimenavitatunava;;;9999023ZC8973804;;;;;
09.03.2023;0273 76460372;;0273 76460372.0;MV30 8436 5080 7434 4343 2;MOX;01.01.2023;31.01.2023;COR Momulamquado Scipsilocet;23.01.2023;23.01.2023;23.01.2023;Conatunubelegro HAT;;;9999023ZC8973804;;;;;
09.03.2023;0273 76460372;;0273 76460372.0;MV30 8436 5080 7434 4343 2;MOX;01.01.2023;31.01.2023;COR Momulamquado Scipsilocet;23.01.2023;23.01.2023;23.01.2023;Minnent agrascem Aciroducultinquaestimo;;;9999023ZC8973804;;;;;
09.03.2023;0273 76460372;;0273 76460372.0;MV30 8436 5080 7434 4343 2;MOX;01.01.2023;31.01.2023;COR Momulamquado Scipsilocet;23.01.2023;23.01.2023;23.01.2023;Mitaümili;AUCEM ADIVITATE;VENDISTAS 4, 6265 BRUNTUS, AT, VENDEDEINCERVIS: N-15044 SION AUTAS, WIRIANA: 12520 PARARIS COR: 31.73.7, 761;9999023ZC8975260;;;;5'600.00;49'731.18
09.03.2023;0273 76460372;;0273 76460372.0;MV30 8436 5080 7434 4343 2;MOX;01.01.2023;31.01.2023;COR Momulamquado Scipsilocet;23.01.2023;23.01.2023;23.01.2023;Sendividiam- per Autimenavitatunava;;;9999023ZC8975260;;;;;
09.03.2023;0273 76460372;;0273 76460372.0;MV30 8436 5080 7434 4343 2;MOX;01.01.2023;31.01.2023;COR Momulamquado Scipsilocet;23.01.2023;23.01.2023;23.01.2023;Conatunubelegro HAT;;;9999023ZC8975260;;;;;
09.03.2023;0273 76460372;;0273 76460372.0;MV30 8436 5080 7434 4343 2;MOX;01.01.2023;31.01.2023;COR Momulamquado Scipsilocet;23.01.2023;23.01.2023;23.01.2023;Minnent agrascem Aciroducultinquaestimo;;;9999023ZC8975260;;;;;
09.03.2023;0273 76460372;;0273 76460372.0;MV30 8436 5080 7434 4343 2;MOX;01.01.2023;31.01.2023;COR Momulamquado Scipsilocet;23.01.2023;23.01.2023;23.01.2023;Portuuntio;INERIGERE PARAEPE BY;8005 ZUERICH, /ROC/202301190004781, ALL  /   5028.10/NR.0090004781/KOM., 42.24/DAT.19.01.2023/BIKE + CLIMB, UP     /IBACH, Gutschrifts- und Belastungsanzeigen;9901520E69807637;;;;4'985.86;54'717.04
09.03.2023;0273 76460372;;0273 76460372.0;MV30 8436 5080 7434 4343 2;MOX;01.01.2023;31.01.2023;COR Momulamquado Scipsilocet;23.01.2023;23.01.2023;23.01.2023;Mitaümili;CALTUM SCERI;VICCHRIUSIMULAE 23, AT/MATUNT 6201, IUNC.AN. N-10313 CASPER AN. 8334;9999023ZC8780892;;;;3'100.00;57'817.04
09.03.2023;0273 76460372;;0273 76460372.0;MV30 8436 5080 7434 4343 2;MOX;01.01.2023;31.01.2023;COR Momulamquado Scipsilocet;23.01.2023;23.01.2023;23.01.2023;Sendividiam- per Autimenavitatunava;;;9999023ZC8780892;;;;;
09.03.2023;0273 76460372;;0273 76460372.0;MV30 8436 5080 7434 4343 2;MOX;01.01.2023;31.01.2023;COR Momulamquado Scipsilocet;23.01.2023;23.01.2023;23.01.2023;Conatunubelegro HAT;;;9999023ZC8780892;;;;;
09.03.2023;0273 76460372;;0273 76460372.0;MV30 8436 5080 7434 4343 2;MOX;01.01.2023;31.01.2023;COR Momulamquado Scipsilocet;23.01.2023;23.01.2023;23.01.2023;Minnent agrascem Aciroducultinquaestimo;;;9999023ZC8780892;;;;;
09.03.2023;0273 76460372;;0273 76460372.0;MV30 8436 5080 7434 4343 2;MOX;01.01.2023;31.01.2023;COR Momulamquado Scipsilocet;23.01.2023;23.01.2023;23.01.2023;Mitaümili;CONEQUA CALTUM;ADUNT PRONSTIUNT 7, 3651 IUVIUVIT DE, AT, VENDEDEINCERVIS: N-43654 SION AUTAS, WIRIANA: 5836080 PARARIS COR: 31.73, .6017;9999023ZC9052020;;;;249.85;58'066.89
09.03.2023;0273 76460372;;0273 76460372.0;MV30 8436 5080 7434 4343 2;MOX;01.01.2023;31.01.2023;COR Momulamquado Scipsilocet;23.01.2023;23.01.2023;23.01.2023;Sendividiam- per Autimenavitatunava;;;9999023ZC9052020;;;;;
09.03.2023;0273 76460372;;0273 76460372.0;MV30 8436 5080 7434 4343 2;MOX;01.01.2023;31.01.2023;COR Momulamquado Scipsilocet;23.01.2023;23.01.2023;23.01.2023;Conatunubelegro HAT;;;9999023ZC9052020;;;;;
09.03.2023;0273 76460372;;0273 76460372.0;MV30 8436 5080 7434 4343 2;MOX;01.01.2023;31.01.2023;COR Momulamquado Scipsilocet;23.01.2023;23.01.2023;23.01.2023;Minnent agrascem Aciroducultinquaestimo;;;9999023ZC9052020;;;;;
09.03.2023;0273 76460372;;0273 76460372.0;MV30 8436 5080 7434 4343 2;MOX;01.01.2023;31.01.2023;COR Momulamquado Scipsilocet;24.01.2023;24.01.2023;24.01.2023;Portuuntio;INERIGERE PARAEPE BY;8005 ZUERICH, /ROC/202301210010238, ALL  /   6291.35/NR.0010010238/KOM., 47.22/DAT.21.01.2023/BIKE + CLIMB, UP     /IBACH, Gutschrifts- und Belastungsanzeigen;9901522E63070143;;;;6'244.13;64'311.02
09.03.2023;0273 76460372;;0273 76460372.0;MV30 8436 5080 7434 4343 2;MOX;01.01.2023;31.01.2023;COR Momulamquado Scipsilocet;24.01.2023;24.01.2023;24.01.2023;Ligneranate;GMQ8E RENTUDITQUE VI COR;DOMNIS 41 FLONE, INTIMITIPE BY, 2602 ATUSUS;9973524KH7480983;;;231.18;;64'079.84
09.03.2023;0273 76460372;;0273 76460372.0;MV30 8436 5080 7434 4343 2;MOX;01.01.2023;31.01.2023;COR Momulamquado Scipsilocet;24.01.2023;24.01.2023;24.01.2023;Sendividiam- per Autimenavitatunava;;;9973524KH7480983;;;;;
09.03.2023;0273 76460372;;0273 76460372.0;MV30 8436 5080 7434 4343 2;MOX;01.01.2023;31.01.2023;COR Momulamquado Scipsilocet;24.01.2023;24.01.2023;24.01.2023;PRA Volfabeat MOX;;;9973524KH7480983;;;;;
09.03.2023;0273 76460372;;0273 76460372.0;MV30 8436 5080 7434 4343 2;MOX;01.01.2023;31.01.2023;COR Momulamquado Scipsilocet;24.01.2023;24.01.2023;24.01.2023;Minnent agrascem Aciroducultinquaestimo;;;9973524KH7480983;;;;;
09.03.2023;0273 76460372;;0273 76460372.0;MV30 8436 5080 7434 4343 2;MOX;01.01.2023;31.01.2023;COR Momulamquado Scipsilocet;23.01.2023;24.01.2023;24.01.2023;Mitaüdidissictrum;;;ES74242C47868462;;;18'923.24;;45'156.60
09.03.2023;0273 76460372;;0273 76460372.0;MV30 8436 5080 7434 4343 2;MOX;01.01.2023;31.01.2023;COR Momulamquado Scipsilocet;23.01.2023;24.01.2023;24.01.2023;FIGUN SUUNIS AT;AT 6882 MINITION;;ES74242C47868462;;-87.250000000;;;
09.03.2023;0273 76460372;;0273 76460372.0;MV30 8436 5080 7434 4343 2;MOX;01.01.2023;31.01.2023;COR Momulamquado Scipsilocet;23.01.2023;24.01.2023;24.01.2023;FIGUN SUUNIS AT;AT 6882 MINITION;;ES74242C47868462;;-68.950000000;;;
09.03.2023;0273 76460372;;0273 76460372.0;MV30 8436 5080 7434 4343 2;MOX;01.01.2023;31.01.2023;COR Momulamquado Scipsilocet;23.01.2023;24.01.2023;24.01.2023;HARUM CUNTENIFIENT;DE TANGENT 52145;;ES74242C47868462;;-58.840000000;;;
09.03.2023;0273 76460372;;0273 76460372.0;MV30 8436 5080 7434 4343 2;MOX;01.01.2023;31.01.2023;COR Momulamquado Scipsilocet;23.01.2023;24.01.2023;24.01.2023;HARUM CUNTENIFIENT;DE TANGENT 52145;;ES74242C47868462;;-58.840000000;;;
09.03.2023;0273 76460372;;0273 76460372.0;MV30 8436 5080 7434 4343 2;MOX;01.01.2023;31.01.2023;COR Momulamquado Scipsilocet;23.01.2023;24.01.2023;24.01.2023;SEREGITQUAM BY;AT 5360 HODUNTRIGE;;ES74242C47868462;;-27.350000000;;;
09.03.2023;0273 76460372;;0273 76460372.0;MV30 8436 5080 7434 4343 2;MOX;01.01.2023;31.01.2023;COR Momulamquado Scipsilocet;23.01.2023;24.01.2023;24.01.2023;ALUCI SUUNIS DIFIG BY;AT AT-7267 RECT;;ES74242C47868462;;-541.950000000;;;
09.03.2023;0273 76460372;;0273 76460372.0;MV30 8436 5080 7434 4343 2;MOX;01.01.2023;31.01.2023;COR Momulamquado Scipsilocet;23.01.2023;24.01.2023;24.01.2023;WIDE BY;AT ABABABO 2558;;ES74242C47868462;;-462.450000000;;;
09.03.2023;0273 76460372;;0273 76460372.0;MV30 8436 5080 7434 4343 2;MOX;01.01.2023;31.01.2023;COR Momulamquado Scipsilocet;23.01.2023;24.01.2023;24.01.2023;"6UIF PARAEPE; INE-DIVISTA COGNEQUIT";MINGINULUS 37;AT MATUNT 6201;ES74242C47868462;;-390.000000000;;
09.03.2023;0273 76460372;;0273 76460372.0;MV30 8436 5080 7434 4343 2;MOX;01.01.2023;31.01.2023;COR Momulamquado Scipsilocet;23.01.2023;24.01.2023;24.01.2023;ATE VINATE & OPTURRUM PRA. BY;AT 2332 MINTO;;ES74242C47868462;;-369.700000000;;;
09.03.2023;0273 76460372;;0273 76460372.0;MV30 8436 5080 7434 4343 2;MOX;01.01.2023;31.01.2023;COR Momulamquado Scipsilocet;23.01.2023;24.01.2023;24.01.2023;RIGE;AT 6847 IECTEM;;ES74242C47868462;;-9765.700000000;;;
09.03.2023;0273 76460372;;0273 76460372.0;MV30 8436 5080 7434 4343 2;MOX;01.01.2023;31.01.2023;COR Momulamquado Scipsilocet;23.01.2023;24.01.2023;24.01.2023;SIVICUNDIONAVA CHOMNUNE SERCULLACTO;AT ADUM 6462;;ES74242C47868462;;-5456.100000000;;;
09.03.2023;0273 76460372;;0273 76460372.0;MV30 8436 5080 7434 4343 2;MOX;01.01.2023;31.01.2023;COR Momulamquado Scipsilocet;23.01.2023;24.01.2023;24.01.2023;SIVICUNDIONAVA CHOMNUNE SERCULLACTO;AT ADUM 6462;;ES74242C47868462;;-889.750000000;;;
09.03.2023;0273 76460372;;0273 76460372.0;MV30 8436 5080 7434 4343 2;MOX;01.01.2023;31.01.2023;COR Momulamquado Scipsilocet;23.01.2023;24.01.2023;24.01.2023;HARUM CUNTENIFIENT;DE TANGENT 52145;;ES74242C47868462;;-746.360000000;;;
09.03.2023;0273 76460372;;0273 76460372.0;MV30 8436 5080 7434 4343 2;MOX;01.01.2023;31.01.2023;COR Momulamquado Scipsilocet;25.01.2023;25.01.2023;25.01.2023;Mitaümili;QUIS CHABIBO;DE. LIUSTQUAM 63, 1780 FICA, AT, VENDEDEINCERVIS: N-64736 SION AUTAS, WIRIANA: 7558046 PARARIS COR: 10.73, .6017;9999025ZC0251727;;;;4'100.00;49'256.60
09.03.2023;0273 76460372;;0273 76460372.0;MV30 8436 5080 7434 4343 2;MOX;01.01.2023;31.01.2023;COR Momulamquado Scipsilocet;25.01.2023;25.01.2023;25.01.2023;Sendividiam- per Autimenavitatunava;;;9999025ZC0251727;;;;;
09.03.2023;0273 76460372;;0273 76460372.0;MV30 8436 5080 7434 4343 2;MOX;01.01.2023;31.01.2023;COR Momulamquado Scipsilocet;25.01.2023;25.01.2023;25.01.2023;Conatunubelegro HAT;;;9999025ZC0251727;;;;;
09.03.2023;0273 76460372;;0273 76460372.0;MV30 8436 5080 7434 4343 2;MOX;01.01.2023;31.01.2023;COR Momulamquado Scipsilocet;25.01.2023;25.01.2023;25.01.2023;Minnent agrascem Aciroducultinquaestimo;;;9999025ZC0251727;;;;;
09.03.2023;0273 76460372;;0273 76460372.0;MV30 8436 5080 7434 4343 2;MOX;01.01.2023;31.01.2023;COR Momulamquado Scipsilocet;25.01.2023;25.01.2023;25.01.2023;Ligneranate;EUK8D RENTUDITQUE VI COR;DOMNIS 41 FLONE, MATIS-PULECT BY, 1308 LAMAGE;9973525KH7795546;;;16'065.85;;33'190.75
09.03.2023;0273 76460372;;0273 76460372.0;MV30 8436 5080 7434 4343 2;MOX;01.01.2023;31.01.2023;COR Momulamquado Scipsilocet;25.01.2023;25.01.2023;25.01.2023;Sendividiam- per Autimenavitatunava;;;9973525KH7795546;;;;;
09.03.2023;0273 76460372;;0273 76460372.0;MV30 8436 5080 7434 4343 2;MOX;01.01.2023;31.01.2023;COR Momulamquado Scipsilocet;25.01.2023;25.01.2023;25.01.2023;PRA Volfabeat MOX;;;9973525KH7795546;;;;;
09.03.2023;0273 76460372;;0273 76460372.0;MV30 8436 5080 7434 4343 2;MOX;01.01.2023;31.01.2023;COR Momulamquado Scipsilocet;25.01.2023;25.01.2023;25.01.2023;Minnent agrascem Aciroducultinquaestimo;;;9973525KH7795546;;;;;
09.03.2023;0273 76460372;;0273 76460372.0;MV30 8436 5080 7434 4343 2;MOX;01.01.2023;31.01.2023;COR Momulamquado Scipsilocet;26.01.2023;26.01.2023;26.01.2023;Mitaümili;RATERIAMORGERIS OFFIG 36;FUGAURBITABIT 8, AT/ADUM 8523,                 ...,  WEEK . TERET DE BY,   SCUSTARE MORE 36.42-48.42  4'346., 14;9999026ZC0781377;;;;3'281.45;36'472.20
09.03.2023;0273 76460372;;0273 76460372.0;MV30 8436 5080 7434 4343 2;MOX;01.01.2023;31.01.2023;COR Momulamquado Scipsilocet;26.01.2023;26.01.2023;26.01.2023;Sendividiam- per Autimenavitatunava;;;9999026ZC0781377;;;;;
09.03.2023;0273 76460372;;0273 76460372.0;MV30 8436 5080 7434 4343 2;MOX;01.01.2023;31.01.2023;COR Momulamquado Scipsilocet;26.01.2023;26.01.2023;26.01.2023;Conatunubelegro HAT;;;9999026ZC0781377;;;;;
09.03.2023;0273 76460372;;0273 76460372.0;MV30 8436 5080 7434 4343 2;MOX;01.01.2023;31.01.2023;COR Momulamquado Scipsilocet;26.01.2023;26.01.2023;26.01.2023;Minnent agrascem Aciroducultinquaestimo;;;9999026ZC0781377;;;;;
09.03.2023;0273 76460372;;0273 76460372.0;MV30 8436 5080 7434 4343 2;MOX;01.01.2023;31.01.2023;COR Momulamquado Scipsilocet;25.01.2023;26.01.2023;26.01.2023;Ligneranate;PLUDO;DIANT BY, AT 7526 PULTUDO, BY.7346206477 REM 64.36.6017;9973525KH7804794;;;3'887.97;;32'584.23
09.03.2023;0273 76460372;;0273 76460372.0;MV30 8436 5080 7434 4343 2;MOX;01.01.2023;31.01.2023;COR Momulamquado Scipsilocet;25.01.2023;26.01.2023;26.01.2023;Sendividiam- per Autimenavitatunava;;;9973525KH7804794;;;;;
09.03.2023;0273 76460372;;0273 76460372.0;MV30 8436 5080 7434 4343 2;MOX;01.01.2023;31.01.2023;COR Momulamquado Scipsilocet;25.01.2023;26.01.2023;26.01.2023;PRA Volfabeat MOX;;;9973525KH7804794;;;;;
09.03.2023;0273 76460372;;0273 76460372.0;MV30 8436 5080 7434 4343 2;MOX;01.01.2023;31.01.2023;COR Momulamquado Scipsilocet;25.01.2023;26.01.2023;26.01.2023;Minnent agrascem Aciroducultinquaestimo;;;9973525KH7804794;;;;;
09.03.2023;0273 76460372;;0273 76460372.0;MV30 8436 5080 7434 4343 2;MOX;01.01.2023;31.01.2023;COR Momulamquado Scipsilocet;26.01.2023;27.01.2023;26.01.2023;Deropietio COR Bantuunt;TRIES 44300233-7 8510;COR Fectus, PRA 65.36.10 31:31:63 EX: 88260400, PUPERM MOX 8,885.53;9930527BN4777006;;;;5'000.00;37'584.23
09.03.2023;0273 76460372;;0273 76460372.0;MV30 8436 5080 7434 4343 2;MOX;01.01.2023;31.01.2023;COR Momulamquado Scipsilocet;27.01.2023;27.01.2023;27.01.2023;Portuuntio;INERIGERE PARAEPE BY;8005 ZUERICH, /ROC/202301250006470, ALL  /   3841.05/NR.0050006470/KOM., 33.02/DAT.25.01.2023/BIKE + CLIMB, UP     /IBACH, Gutschrifts- und Belastungsanzeigen;9901526E63854136;;;;3'808.03;41'392.26
09.03.2023;0273 76460372;;0273 76460372.0;MV30 8436 5080 7434 4343 2;MOX;01.01.2023;31.01.2023;COR Momulamquado Scipsilocet;27.01.2023;27.01.2023;27.01.2023;g-intetis-Cogitus;ABEAT BY;AT, BY. 3742031 - 7% AEQUAE;9973026TI2091891;;;205.84;;41'186.42
09.03.2023;0273 76460372;;0273 76460372.0;MV30 8436 5080 7434 4343 2;MOX;01.01.2023;31.01.2023;COR Momulamquado Scipsilocet;27.01.2023;27.01.2023;27.01.2023;K-Intetis MOX Putulo;;;9973026TI2091891;;;;;
09.03.2023;0273 76460372;;0273 76460372.0;MV30 8436 5080 7434 4343 2;MOX;01.01.2023;31.01.2023;COR Momulamquado Scipsilocet;27.01.2023;27.01.2023;27.01.2023;Minnent agrascem Aciroducultinquaestimo;;;9973026TI2091891;;;;;
09.03.2023;0273 76460372;;0273 76460372.0;MV30 8436 5080 7434 4343 2;MOX;01.01.2023;31.01.2023;COR Momulamquado Scipsilocet;27.01.2023;27.01.2023;27.01.2023;Mineque Lodiscususäan;VADETUS FECTANGUIS BY;Sendividiam- per Autimenavitatunava;9973527LP2660450;;;291.00;;40'895.42
09.03.2023;0273 76460372;;0273 76460372.0;MV30 8436 5080 7434 4343 2;MOX;01.01.2023;31.01.2023;COR Momulamquado Scipsilocet;26.01.2023;27.01.2023;27.01.2023;Ligneranate;FACUT RENTUDITQUE VI COR;DOMNIS 41 FLONE, AUSTAM . UT BY, 2748 HYACTAMIUNT, 6017/36/10 / 6277864;9973526KH7899865;;;365.50;;40'529.92
09.03.2023;0273 76460372;;0273 76460372.0;MV30 8436 5080 7434 4343 2;MOX;01.01.2023;31.01.2023;COR Momulamquado Scipsilocet;26.01.2023;27.01.2023;27.01.2023;Sendividiam- per Autimenavitatunava;;;9973526KH7899865;;;;;
09.03.2023;0273 76460372;;0273 76460372.0;MV30 8436 5080 7434 4343 2;MOX;01.01.2023;31.01.2023;COR Momulamquado Scipsilocet;26.01.2023;27.01.2023;27.01.2023;PRA Volfabeat MOX;;;9973526KH7899865;;;;;
09.03.2023;0273 76460372;;0273 76460372.0;MV30 8436 5080 7434 4343 2;MOX;01.01.2023;31.01.2023;COR Momulamquado Scipsilocet;26.01.2023;27.01.2023;27.01.2023;Minnent agrascem Aciroducultinquaestimo;;;9973526KH7899865;;;;;
09.03.2023;0273 76460372;;0273 76460372.0;MV30 8436 5080 7434 4343 2;MOX;01.01.2023;31.01.2023;COR Momulamquado Scipsilocet;27.01.2023;27.01.2023;27.01.2023;g-intetis-Pillameruntio;;;9973027TJ9524800;;;779.20;;39'750.72
09.03.2023;0273 76460372;;0273 76460372.0;MV30 8436 5080 7434 4343 2;MOX;01.01.2023;31.01.2023;COR Momulamquado Scipsilocet;27.01.2023;27.01.2023;27.01.2023;DENTE VERE, NERATEGO 5744, UT-12766;AT;;9973027TJ9524800;;-176.240000000;;;
09.03.2023;0273 76460372;;0273 76460372.0;MV30 8436 5080 7434 4343 2;MOX;01.01.2023;31.01.2023;COR Momulamquado Scipsilocet;27.01.2023;27.01.2023;27.01.2023;AUCEM MANDUM SUPA + UT. IN;MAGNUNGULLUNT 7;82487 OBERAMMERGAU, DE;9973027TJ9524800;;-602.960000000;;;
09.03.2023;0273 76460372;;0273 76460372.0;MV30 8436 5080 7434 4343 2;MOX;01.01.2023;31.01.2023;COR Momulamquado Scipsilocet;27.01.2023;27.01.2023;27.01.2023;Mineque Lodiscususäan;;;9973527LP2660350;;;2'901.93;;36'848.79
09.03.2023;0273 76460372;;0273 76460372.0;MV30 8436 5080 7434 4343 2;MOX;01.01.2023;31.01.2023;COR Momulamquado Scipsilocet;27.01.2023;27.01.2023;27.01.2023;WIRE AUDIT, 8510 PRANT;;;9973527LP2660350;;-1151.560000000;;;
09.03.2023;0273 76460372;;0273 76460372.0;MV30 8436 5080 7434 4343 2;MOX;01.01.2023;31.01.2023;COR Momulamquado Scipsilocet;27.01.2023;27.01.2023;27.01.2023;SPLAM AUTALAM;;;9973527LP2660350;;-598.810000000;;;
09.03.2023;0273 76460372;;0273 76460372.0;MV30 8436 5080 7434 4343 2;MOX;01.01.2023;31.01.2023;COR Momulamquado Scipsilocet;27.01.2023;27.01.2023;27.01.2023;FUIREM VADO, AUSQUAESET AT;;;9973527LP2660350;;-1151.560000000;;;
09.03.2023;0273 76460372;;0273 76460372.0;MV30 8436 5080 7434 4343 2;MOX;01.01.2023;31.01.2023;COR Momulamquado Scipsilocet;27.01.2023;27.01.2023;27.01.2023;Belinundetsi;NATET PERAE;ASUM BELINUNDETSI;9973527LK4232087;;;5'953.65;;30'895.14
09.03.2023;0273 76460372;;0273 76460372.0;MV30 8436 5080 7434 4343 2;MOX;01.01.2023;31.01.2023;COR Momulamquado Scipsilocet;27.01.2023;27.01.2023;27.01.2023;K-Intetis MOX Putulo;;;9973527LK4232087;;;;;
09.03.2023;0273 76460372;;0273 76460372.0;MV30 8436 5080 7434 4343 2;MOX;01.01.2023;31.01.2023;COR Momulamquado Scipsilocet;27.01.2023;27.01.2023;27.01.2023;Minnent agrascem Aciroducultinquaestimo;;;9973527LK4232087;;;;;
09.03.2023;0273 76460372;;0273 76460372.0;MV30 8436 5080 7434 4343 2;MOX;01.01.2023;31.01.2023;COR Momulamquado Scipsilocet;27.01.2023;27.01.2023;27.01.2023;Mineque Lodiscususäan;;;9973527LP2660410;;;17'543.71;;13'351.43
09.03.2023;0273 76460372;;0273 76460372.0;MV30 8436 5080 7434 4343 2;MOX;01.01.2023;31.01.2023;COR Momulamquado Scipsilocet;27.01.2023;27.01.2023;27.01.2023;SIMULUS UNGISI;6467 SCHATTDORF;;9973527LP2660410;;-4577.960000000;;;
09.03.2023;0273 76460372;;0273 76460372.0;MV30 8436 5080 7434 4343 2;MOX;01.01.2023;31.01.2023;COR Momulamquado Scipsilocet;27.01.2023;27.01.2023;27.01.2023;UNGISI DOMNIS;6467 SCHATTDORF;;9973527LP2660410;;-5230.880000000;;;
09.03.2023;0273 76460372;;0273 76460372.0;MV30 8436 5080 7434 4343 2;MOX;01.01.2023;31.01.2023;COR Momulamquado Scipsilocet;27.01.2023;27.01.2023;27.01.2023;LIUNE PERAE;6422 STEINEN;;9973527LP2660410;;-4678.300000000;;;
09.03.2023;0273 76460372;;0273 76460372.0;MV30 8436 5080 7434 4343 2;MOX;01.01.2023;31.01.2023;COR Momulamquado Scipsilocet;27.01.2023;27.01.2023;27.01.2023;CALECT UNGISI;6467 SCHATTDORF;;9973527LP2660410;;-3056.570000000;;;
09.03.2023;0273 76460372;;0273 76460372.0;MV30 8436 5080 7434 4343 2;MOX;01.01.2023;31.01.2023;COR Momulamquado Scipsilocet;30.01.2023;30.01.2023;30.01.2023;Mitaümili;ARTER PAM;ATULLANA 4, 5012 AUSQUAESET O. FECTUS, AT;9999030ZC2033882;;;;2'571.45;15'922.88
09.03.2023;0273 76460372;;0273 76460372.0;MV30 8436 5080 7434 4343 2;MOX;01.01.2023;31.01.2023;COR Momulamquado Scipsilocet;30.01.2023;30.01.2023;30.01.2023;Sendividiam- per Autimenavitatunava;;;9999030ZC2033882;;;;;
09.03.2023;0273 76460372;;0273 76460372.0;MV30 8436 5080 7434 4343 2;MOX;01.01.2023;31.01.2023;COR Momulamquado Scipsilocet;30.01.2023;30.01.2023;30.01.2023;Conatunubelegro HAT;;;9999030ZC2033882;;;;;
09.03.2023;0273 76460372;;0273 76460372.0;MV30 8436 5080 7434 4343 2;MOX;01.01.2023;31.01.2023;COR Momulamquado Scipsilocet;30.01.2023;30.01.2023;30.01.2023;Minnent agrascem Aciroducultinquaestimo;;;9999030ZC2033882;;;;;
09.03.2023;0273 76460372;;0273 76460372.0;MV30 8436 5080 7434 4343 2;MOX;01.01.2023;31.01.2023;COR Momulamquado Scipsilocet;30.01.2023;30.01.2023;30.01.2023;Mitaümili;PULUVA HYACCIPARIUNCH;ALIURURGENTUUS 632, 3651 SEPASUS DE, AT, VENDEDEINCERVIS: N-60480 FLUVINSTIS, EX: 3837785;9999030ZC1848528;;;;80.00;16'002.88
09.03.2023;0273 76460372;;0273 76460372.0;MV30 8436 5080 7434 4343 2;MOX;01.01.2023;31.01.2023;COR Momulamquado Scipsilocet;30.01.2023;30.01.2023;30.01.2023;Sendividiam- per Autimenavitatunava;;;9999030ZC1848528;;;;;
09.03.2023;0273 76460372;;0273 76460372.0;MV30 8436 5080 7434 4343 2;MOX;01.01.2023;31.01.2023;COR Momulamquado Scipsilocet;30.01.2023;30.01.2023;30.01.2023;Conatunubelegro HAT;;;9999030ZC1848528;;;;;
09.03.2023;0273 76460372;;0273 76460372.0;MV30 8436 5080 7434 4343 2;MOX;01.01.2023;31.01.2023;COR Momulamquado Scipsilocet;30.01.2023;30.01.2023;30.01.2023;Minnent agrascem Aciroducultinquaestimo;;;9999030ZC1848528;;;;;
09.03.2023;0273 76460372;;0273 76460372.0;MV30 8436 5080 7434 4343 2;MOX;01.01.2023;31.01.2023;COR Momulamquado Scipsilocet;30.01.2023;30.01.2023;30.01.2023;Mineque Lodiscususäan;PONSA CONERRA-CARATE;6430 SCHWYZ;9973530LP3021340;;;80.00;;15'922.88
09.03.2023;0273 76460372;;0273 76460372.0;MV30 8436 5080 7434 4343 2;MOX;01.01.2023;31.01.2023;COR Momulamquado Scipsilocet;30.01.2023;30.01.2023;30.01.2023;Ligneranate;AJG2J RENTUDITQUE VI COR;DOMNIS 41 FLONE, IMPUNIAM (PARAEPE) BY, 8882 PERCIETUER, CULUCTURSERITA: 3306822, SCUSTARE PRA 55.36.6017, SCUSTARE AN. 1233766733435020, EXERIUNT +61322623200;9973530KH8118988;;;119.80;;15'803.08
09.03.2023;0273 76460372;;0273 76460372.0;MV30 8436 5080 7434 4343 2;MOX;01.01.2023;31.01.2023;COR Momulamquado Scipsilocet;30.01.2023;30.01.2023;30.01.2023;Sendividiam- per Autimenavitatunava;;;9973530KH8118988;;;;;
09.03.2023;0273 76460372;;0273 76460372.0;MV30 8436 5080 7434 4343 2;MOX;01.01.2023;31.01.2023;COR Momulamquado Scipsilocet;30.01.2023;30.01.2023;30.01.2023;PRA Volfabeat MOX;;;9973530KH8118988;;;;;
09.03.2023;0273 76460372;;0273 76460372.0;MV30 8436 5080 7434 4343 2;MOX;01.01.2023;31.01.2023;COR Momulamquado Scipsilocet;30.01.2023;30.01.2023;30.01.2023;Minnent agrascem Aciroducultinquaestimo;;;9973530KH8118988;;;;;
09.03.2023;0273 76460372;;0273 76460372.0;MV30 8436 5080 7434 4343 2;MOX;01.01.2023;31.01.2023;COR Momulamquado Scipsilocet;31.01.2023;31.01.2023;31.01.2023;Portuuntio;INERIGERE PARAEPE BY;8005 ZUERICH, /ROC/202301280007677, ALL  /   8414.55/NR.0080007677/KOM., 54.62/DAT.28.01.2023/BIKE + CLIMB, UP     /IBACH, Gutschrifts- und Belastungsanzeigen;9901529E64242002;;;;8'359.93;24'163.01
09.03.2023;0273 76460372;;0273 76460372.0;MV30 8436 5080 7434 4343 2;MOX;01.01.2023;31.01.2023;COR Momulamquado Scipsilocet;31.01.2023;31.01.2023;31.01.2023;Portuuntio;INERIGERE PARAEPE BY;8005 ZUERICH, /ROC/202301270011258, ALL  /   8237.15/NR.0070011258/KOM., 59.23/DAT.27.01.2023/BIKE + CLIMB, UP     /IBACH, Gutschrifts- und Belastungsanzeigen;9901528E64169353;;;;8'177.92;32'340.93
09.03.2023;0273 76460372;;0273 76460372.0;MV30 8436 5080 7434 4343 2;MOX;01.01.2023;31.01.2023;COR Momulamquado Scipsilocet;31.01.2023;31.01.2023;31.01.2023;Mitaümili;REGO STICEM CONTERO;DOMENATUISSIME 20/8, 1556 OSTIFICUTINE, AT, VENDEDEINCERVIS: N-57768 SION AUTAS, WIRIANA: 1540 PARARIS COR: 13.73.35, 10;9999031ZC3190879;;;;373.00;32'713.93
09.03.2023;0273 76460372;;0273 76460372.0;MV30 8436 5080 7434 4343 2;MOX;01.01.2023;31.01.2023;COR Momulamquado Scipsilocet;31.01.2023;31.01.2023;31.01.2023;Sendividiam- per Autimenavitatunava;;;9999031ZC3190879;;;;;
09.03.2023;0273 76460372;;0273 76460372.0;MV30 8436 5080 7434 4343 2;MOX;01.01.2023;31.01.2023;COR Momulamquado Scipsilocet;31.01.2023;31.01.2023;31.01.2023;Conatunubelegro HAT;;;9999031ZC3190879;;;;;
09.03.2023;0273 76460372;;0273 76460372.0;MV30 8436 5080 7434 4343 2;MOX;01.01.2023;31.01.2023;COR Momulamquado Scipsilocet;31.01.2023;31.01.2023;31.01.2023;Minnent agrascem Aciroducultinquaestimo;;;9999031ZC3190879;;;;;
09.03.2023;0273 76460372;;0273 76460372.0;MV30 8436 5080 7434 4343 2;MOX;01.01.2023;31.01.2023;COR Momulamquado Scipsilocet;31.01.2023;31.01.2023;31.01.2023;Mitaümili;BRUMQUO-EXPERCUS SIMPLE;FRESTRICERES 1, AT/ANTIUNDI 4308, VENDEDEINCERVIS: N-70711 SION AUTAS,  WIRIANA: 6237 PARARIS COR: 31.73.7, 2 10;9999031ZC2909532;;;;335.30;33'049.23
09.03.2023;0273 76460372;;0273 76460372.0;MV30 8436 5080 7434 4343 2;MOX;01.01.2023;31.01.2023;COR Momulamquado Scipsilocet;31.01.2023;31.01.2023;31.01.2023;Sendividiam- per Autimenavitatunava;;;9999031ZC2909532;;;;;
09.03.2023;0273 76460372;;0273 76460372.0;MV30 8436 5080 7434 4343 2;MOX;01.01.2023;31.01.2023;COR Momulamquado Scipsilocet;31.01.2023;31.01.2023;31.01.2023;Conatunubelegro HAT;;;9999031ZC2909532;;;;;
09.03.2023;0273 76460372;;0273 76460372.0;MV30 8436 5080 7434 4343 2;MOX;01.01.2023;31.01.2023;COR Momulamquado Scipsilocet;31.01.2023;31.01.2023;31.01.2023;Minnent agrascem Aciroducultinquaestimo;;;9999031ZC2909532;;;;;
09.03.2023;0273 76460372;;0273 76460372.0;MV30 8436 5080 7434 4343 2;MOX;01.01.2023;31.01.2023;COR Momulamquado Scipsilocet;31.01.2023;31.01.2023;31.01.2023;Merea DE-Videparenimore;;;ST62401EN1023063;;;73.95;;32'975.28
09.03.2023;0273 76460372;;0273 76460372.0;MV30 8436 5080 7434 4343 2;MOX;01.01.2023;31.01.2023;COR Momulamquado Scipsilocet;31.01.2023;31.01.2023;31.01.2023;01.01.2023 - 31.01.2023;;;ST62401EN1023063;;;;;
09.03.2023;0273 76460372;;0273 76460372.0;MV30 8436 5080 7434 4343 2;MOX;01.01.2023;31.01.2023;COR Momulamquado Scipsilocet;31.01.2023;31.01.2023;31.01.2023;Subüan xxx Pare uüt Lodicarecittiffere;;;ST62401EN1023063;;-3.950000000;;;
09.03.2023;0273 76460372;;0273 76460372.0;MV30 8436 5080 7434 4343 2;MOX;01.01.2023;31.01.2023;COR Momulamquado Scipsilocet;31.01.2023;31.01.2023;31.01.2023;Conatunubelegro HAT;;;ST62401EN1023063;;-5.000000000;;;
09.03.2023;0273 76460372;;0273 76460372.0;MV30 8436 5080 7434 4343 2;MOX;01.01.2023;31.01.2023;COR Momulamquado Scipsilocet;31.01.2023;31.01.2023;31.01.2023;Minnent agrascem Aciroducultinquaestimo;;;ST62401EN1023063;;5.000000000;;;
09.03.2023;0273 76460372;;0273 76460372.0;MV30 8436 5080 7434 4343 2;MOX;01.01.2023;31.01.2023;COR Momulamquado Scipsilocet;31.01.2023;31.01.2023;31.01.2023;Pluvite COR quis;;;ST62401EN1023063;;-70.000000000;;;
09.03.2023;0273 76460372;;0273 76460372.0;MV30 8436 5080 7434 4343 2;MOX;01.01.2023;31.01.2023;COR Momulamquado Scipsilocet;31.01.2023;31.01.2023;31.01.2023;K-Intetis MOX Putulo;;;ST62401EN1023063;;-3.900000000;;;
09.03.2023;0273 76460372;;0273 76460372.0;MV30 8436 5080 7434 4343 2;MOX;01.01.2023;31.01.2023;COR Momulamquado Scipsilocet;31.01.2023;31.01.2023;31.01.2023;Minnent agrascem Aciroducultinquaestimo;;;ST62401EN1023063;;3.900000000;;;
09.03.2023;0273 76460372;;0273 76460372.0;MV30 8436 5080 7434 4343 2;MOX;01.01.2023;31.01.2023;COR Momulamquado Scipsilocet;31.01.2023;31.01.2023;31.01.2023;PRA Volfabeat MOX;;;ST62401EN1023063;;-6.300000000;;;
09.03.2023;0273 76460372;;0273 76460372.0;MV30 8436 5080 7434 4343 2;MOX;01.01.2023;31.01.2023;COR Momulamquado Scipsilocet;31.01.2023;31.01.2023;31.01.2023;Minnent agrascem Aciroducultinquaestimo;;;ST62401EN1023063;;6.300000000;;;
09.03.2023;0273 76460372;;0273 76460372.0;MV30 8436 5080 7434 4343 2;MOX;01.01.2023;31.01.2023;COR Momulamquado Scipsilocet;31.01.2023;31.01.2023;31.01.2023;Belinundetsi MOX Putulo;;;ST62401EN1023063;;-3.300000000;;;
09.03.2023;0273 76460372;;0273 76460372.0;MV30 8436 5080 7434 4343 2;MOX;01.01.2023;31.01.2023;COR Momulamquado Scipsilocet;31.01.2023;31.01.2023;31.01.2023;Minnent agrascem Aciroducultinquaestimo;;;ST62401EN1023063;;3.300000000;;;
09.03.2023;0273 76460372;;0273 76460372.0;MV30 8436 5080 7434 4343 2;MOX;01.01.2023;31.01.2023;COR Momulamquado Scipsilocet;31.01.2023;31.01.2023;31.01.2023;K-Intetis NOUN;;;ST62401EN1023063;;-0.300000000;;;
09.03.2023;0273 76460372;;0273 76460372.0;MV30 8436 5080 7434 4343 2;MOX;01.01.2023;31.01.2023;COR Momulamquado Scipsilocet;31.01.2023;31.01.2023;31.01.2023;Minnent agrascem Aciroducultinquaestimo;;;ST62401EN1023063;;0.300000000;;;
09.03.2023;0273 76460372;;0273 76460372.0;MV30 8436 5080 7434 4343 2;MOX;01.01.2023;31.01.2023;COR Momulamquado Scipsilocet;31.01.2023;31.01.2023;31.01.2023;Ligneranate;GMQ8E RENTUDITQUE VI COR;DOMNIS 41 FLONE, INTIMITIPE BY, 2602 ATUSUS;9973531KH8217586;;;396.85;;32'578.43
09.03.2023;0273 76460372;;0273 76460372.0;MV30 8436 5080 7434 4343 2;MOX;01.01.2023;31.01.2023;COR Momulamquado Scipsilocet;31.01.2023;31.01.2023;31.01.2023;Sendividiam- per Autimenavitatunava;;;9973531KH8217586;;;;;
09.03.2023;0273 76460372;;0273 76460372.0;MV30 8436 5080 7434 4343 2;MOX;01.01.2023;31.01.2023;COR Momulamquado Scipsilocet;31.01.2023;31.01.2023;31.01.2023;PRA Volfabeat MOX;;;9973531KH8217586;;;;;
09.03.2023;0273 76460372;;0273 76460372.0;MV30 8436 5080 7434 4343 2;MOX;01.01.2023;31.01.2023;COR Momulamquado Scipsilocet;31.01.2023;31.01.2023;31.01.2023;Minnent agrascem Aciroducultinquaestimo;;;9973531KH8217586;;;;;
09.03.2023;0273 76460372;;0273 76460372.0;MV30 8436 5080 7434 4343 2;MOX;01.01.2023;31.01.2023;COR Momulamquado Scipsilocet;31.01.2023;31.01.2023;31.01.2023;Ligneranate;GMQ8E RENTUDITQUE VI COR;DOMNIS 41 FLONE, INTIMITIPE BY, 2602 ATUSUS;9973531KH8217812;;;3'530.55;;29'047.88
09.03.2023;0273 76460372;;0273 76460372.0;MV30 8436 5080 7434 4343 2;MOX;01.01.2023;31.01.2023;COR Momulamquado Scipsilocet;31.01.2023;31.01.2023;31.01.2023;Sendividiam- per Autimenavitatunava;;;9973531KH8217812;;;;;
09.03.2023;0273 76460372;;0273 76460372.0;MV30 8436 5080 7434 4343 2;MOX;01.01.2023;31.01.2023;COR Momulamquado Scipsilocet;31.01.2023;31.01.2023;31.01.2023;PRA Volfabeat MOX;;;9973531KH8217812;;;;;
09.03.2023;0273 76460372;;0273 76460372.0;MV30 8436 5080 7434 4343 2;MOX;01.01.2023;31.01.2023;COR Momulamquado Scipsilocet;31.01.2023;31.01.2023;31.01.2023;Minnent agrascem Aciroducultinquaestimo;;;9973531KH8217812;;;;;
09.03.2023;0273 76460372;;0273 76460372.0;MV30 8436 5080 7434 4343 2;MOX;01.01.2023;31.01.2023;COR Momulamquado Scipsilocet;31.01.2023;31.01.2023;31.01.2023;Mineque Lodiscususäan;DOMNICEM REHENDIONGIT;AT FECTUS 4778;9973531LP3585650;;;7'000.00;;22'047.88
09.03.2023;0273 76460372;;0273 76460372.0;MV30 8436 5080 7434 4343 2;MOX;01.01.2023;31.01.2023;COR Momulamquado Scipsilocet;30.01.2023;31.01.2023;31.01.2023;Mitaüdidissictrum;;;JQ18168Y88123511;;;9'927.84;;12'120.04
09.03.2023;0273 76460372;;0273 76460372.0;MV30 8436 5080 7434 4343 2;MOX;01.01.2023;31.01.2023;COR Momulamquado Scipsilocet;30.01.2023;31.01.2023;31.01.2023;NIGNICILLUM;AT 7334 FECTUS;;JQ18168Y88123511;;-755.000000000;;;
09.03.2023;0273 76460372;;0273 76460372.0;MV30 8436 5080 7434 4343 2;MOX;01.01.2023;31.01.2023;COR Momulamquado Scipsilocet;30.01.2023;31.01.2023;31.01.2023;FIGUN SUUNIS AT;AT 6882 MINITION;;JQ18168Y88123511;;-3219.880000000;;;
09.03.2023;0273 76460372;;0273 76460372.0;MV30 8436 5080 7434 4343 2;MOX;01.01.2023;31.01.2023;COR Momulamquado Scipsilocet;30.01.2023;31.01.2023;31.01.2023;ACITARE SUPA;AT PULTUDO 7526;;JQ18168Y88123511;;-773.850000000;;;
09.03.2023;0273 76460372;;0273 76460372.0;MV30 8436 5080 7434 4343 2;MOX;01.01.2023;31.01.2023;COR Momulamquado Scipsilocet;30.01.2023;31.01.2023;31.01.2023;BRUNICA BRUMENSILLUNT-HORBIGINTEMO;CONETINDITATRIME 14;AT BRUNICA 7788;JQ18168Y88123511;;-882.000000000;;;
09.03.2023;0273 76460372;;0273 76460372.0;MV30 8436 5080 7434 4343 2;MOX;01.01.2023;31.01.2023;COR Momulamquado Scipsilocet;30.01.2023;31.01.2023;31.01.2023;RIGE;AT 6847 IECTEM;;JQ18168Y88123511;;-744.850000000;;;
09.03.2023;0273 76460372;;0273 76460372.0;MV30 8436 5080 7434 4343 2;MOX;01.01.2023;31.01.2023;COR Momulamquado Scipsilocet;30.01.2023;31.01.2023;31.01.2023;PRA CANS RENTIA ADRALL AT;AT 6620 PERVIAM-CAERUNT;;JQ18168Y88123511;;-80.650000000;;;
09.03.2023;0273 76460372;;0273 76460372.0;MV30 8436 5080 7434 4343 2;MOX;01.01.2023;31.01.2023;COR Momulamquado Scipsilocet;30.01.2023;31.01.2023;31.01.2023;PARE AT BY;AT 5770 ADUM;;JQ18168Y88123511;;-85.000000000;;;
09.03.2023;0273 76460372;;0273 76460372.0;MV30 8436 5080 7434 4343 2;MOX;01.01.2023;31.01.2023;COR Momulamquado Scipsilocet;30.01.2023;31.01.2023;31.01.2023;FIGUN SUUNIS AT;AT 6882 MINITION;;JQ18168Y88123511;;-103.430000000;;;
09.03.2023;0273 76460372;;0273 76460372.0;MV30 8436 5080 7434 4343 2;MOX;01.01.2023;31.01.2023;COR Momulamquado Scipsilocet;30.01.2023;31.01.2023;31.01.2023;QUADECTO BY;AT 8673 SCRITQUE;;JQ18168Y88123511;;-189.550000000;;;
09.03.2023;0273 76460372;;0273 76460372.0;MV30 8436 5080 7434 4343 2;MOX;01.01.2023;31.01.2023;COR Momulamquado Scipsilocet;30.01.2023;31.01.2023;31.01.2023;ANETUS SUUNIS SULUM BY;AT BABO 6238;;JQ18168Y88123511;;-228.980000000;;;
09.03.2023;0273 76460372;;0273 76460372.0;MV30 8436 5080 7434 4343 2;MOX;01.01.2023;31.01.2023;COR Momulamquado Scipsilocet;30.01.2023;31.01.2023;31.01.2023;"6UIF PARAEPE; INE-DIVISTA COGNEQUIT";MINGINULUS 37;AT MATUNT 6201;JQ18168Y88123511;;-390.000000000;;
09.03.2023;0273 76460372;;0273 76460372.0;MV30 8436 5080 7434 4343 2;MOX;01.01.2023;31.01.2023;COR Momulamquado Scipsilocet;30.01.2023;31.01.2023;31.01.2023;CRITA RESTA XXX;PUPERVESTARTE 31;AT COGNUS 3513;JQ18168Y88123511;;-546.600000000;;;
09.03.2023;0273 76460372;;0273 76460372.0;MV30 8436 5080 7434 4343 2;MOX;01.01.2023;31.01.2023;COR Momulamquado Scipsilocet;30.01.2023;31.01.2023;31.01.2023;SIVICUNDIONAVA CHOMNUNE SERCULLACTO;AT ADUM 6462;;JQ18168Y88123511;;-549.750000000;;;
09.03.2023;0273 76460372;;0273 76460372.0;MV30 8436 5080 7434 4343 2;MOX;01.01.2023;31.01.2023;COR Momulamquado Scipsilocet;30.01.2023;31.01.2023;31.01.2023;ATE VINATE & OPTURRUM PRA. BY;AT 2332 MINTO;;JQ18168Y88123511;;-648.250000000;;;
09.03.2023;0273 76460372;;0273 76460372.0;MV30 8436 5080 7434 4343 2;MOX;01.01.2023;31.01.2023;COR Momulamquado Scipsilocet;30.01.2023;31.01.2023;31.01.2023;PATUMUM BY;AT DE. TANDAM 8632;;JQ18168Y88123511;;-730.050000000;;;
;;;;;;;;;;;;;;;;;;;;
Tatuniatento;Superrentest;;;;;;;;;;;;;;;;;;;
12120.040000000;33447.270000000;;;;;;;;;;;;;;;;;;;

